amortization;interest;balance;dfi;mip;payment;rent;rent_savings;home_value;equity;purchase_savings
694.44;1608.51;249305.56;19.5;79.27916808;2401.72916808;1000.0;250000.0;500000.0;250694.44;220694.44
694.44;1604.04;248611.12;19.5;79.05833616000001;2397.03833616;1000.0;251750.4389416342;500702.87344634836;252091.75344634836;222049.58103956745
694.44;1599.57;247916.68;19.5;78.83750424;2392.34750424;1000.0;253498.64113132906;501406.7349548599;253490.0549548599;223405.6508575683
694.44;1595.1;247222.24;19.5;78.61667232;2387.65667232;1000.0;255244.6034247775;502111.5859144999;254889.3459144999;224762.6507596299
694.44;1590.64;246527.8;19.5;78.3958404;2382.9758404;1000.0;256988.3326873098;502817.4277161862;256289.62771618622;226120.58205321507
694.44;1586.17;245833.36;19.5;78.17500848;2378.28500848;1000.0;258729.81576579218;503524.261752792;257690.901752792;227479.4460476245
694.44;1581.7;245138.91999999998;19.5;77.95417656000001;2373.5941765600005;1000.0;260469.04950265845;504232.0894191484;259093.1694191484;228839.24405399952
694.44;1577.23;244444.47999999998;19.5;77.73334464;2368.90334464;1000.0;262206.0307359036;504940.9121120473;260496.43211204733;230199.97738532448
694.44;1572.76;243750.03999999998;19.5;77.51251272;2364.2125127199997;1000.0;263940.7562990777;505650.7312302443;261900.6912302443;231561.64735642963
694.44;1568.29;243055.59999999998;19.5;77.2916808;2359.5216808;1000.0;265673.2230212795;506361.548174461;263305.948174461;232924.25528399338
694.44;1563.83;242361.15999999997;19.5;77.07084888;2354.84084888;1000.0;267403.4377412078;507073.3643473883;264712.20434738835;234287.80248654506
694.44;1559.36;241666.71999999997;19.5;76.85001696;2350.1500169600004;1000.0;269131.3872790599;507786.1811536889;266119.46115368896;235652.29028446763
694.44;1554.89;240972.27999999997;19.5;76.62918504;2345.4591850399997;1020.0;270755.7892235247;508500.00000000006;267527.7200000001;237017.7200000001
694.44;1550.42;240277.83999999997;19.5;76.40835312;2340.76835312;1020.0;272459.0283520337;509214.82229493634;268936.9822949364;238384.09295724018
694.44;1545.95;239583.39999999997;19.5;76.18752119999999;2336.0775212000003;1020.0;274159.9643776127;509930.6494490925;270347.24944909255;239751.410482147
694.44;1541.49;238888.95999999996;19.5;75.96668928;2331.3966892800004;1020.0;275858.6040767394;510647.4828750464;271758.5228750464;241119.67390254364
694.44;1537.02;238194.51999999996;19.5;75.74585735999999;2326.70585736;1020.0;277554.9342073026;511365.32398736133;273170.8039873614;242488.8845481197
694.44;1532.55;237500.07999999996;19.5;75.52502544;2322.0150254399996;1020.0;279248.9515226334;512084.1742025894;274584.0942025894;243859.04375043407
694.44;1528.08;236805.63999999996;19.5;75.30419352;2317.32419352;1020.0;280940.652771499;512804.0349392738;275998.3949392738;245230.1528429174
694.44;1523.61;236111.19999999995;19.5;75.08336159999999;2312.6333616;1020.0;282630.03469809616;513524.907617952;277413.707617952;246602.2131608749
694.44;1519.15;235416.75999999995;19.5;74.86252968;2307.95252968;1020.0;284317.1040561023;514246.79366115824;278830.0336611583;247975.2260414888
694.44;1514.68;234722.31999999995;19.5;74.64169775999999;2303.26169776;1020.0;286001.8475805738;514969.69449342665;280247.3744934267;249349.1928238211
694.44;1510.21;234027.87999999995;19.5;74.42086583999999;2298.57086584;1020.0;287684.2620019775;515693.61154129374;281665.7315412938;250724.11484881616
694.44;1505.74;233333.43999999994;19.5;74.20003392;2293.88003392;1040.4;289343.9153689472;516418.54623330146;283085.1062333015;252099.99345930343
694.44;1501.27;232638.99999999994;19.5;73.97920199999999;2289.189202;1040.4;290913.90400112944;517144.4999999999;284505.49999999994;253476.82999999996
694.44;1496.81;231944.55999999994;19.5;73.75837007999999;2284.50837008;1040.4;292568.7125892767;517871.47427395004;285926.9142739501;254854.6258175131
694.44;1492.34;231250.11999999994;19.5;73.53753815999998;2279.81753816;1040.4;294221.1499934124;518599.47048972687;287349.35048972693;256233.38226034332
694.44;1487.87;230555.67999999993;19.5;73.31670623999999;2275.1267062399997;1040.4;295871.2128802519;519328.49008392193;288772.810083922;257613.1006788867
694.44;1483.4;229861.23999999993;19.5;73.09587431999998;2270.43587432;1040.4;297518.8979118249;520058.53449514625;290197.2944951463;258993.78242543753
694.44;1478.93;229166.79999999993;19.5;72.87504239999998;2265.7450424;1040.4;299164.20174546883;520789.6051640332;291622.80516403326;260375.42885419127
694.44;1474.47;228472.35999999993;19.5;72.65421047999999;2261.06421048;1040.4;300807.1310478795;521521.70353324123;293049.3435332413;261758.04132124683
694.44;1470.0;227777.91999999993;19.5;72.43337855999998;2256.37337856;1040.4;302447.6724670096;522254.83104745694;294476.911047457;263141.6211846096
694.44;1465.53;227083.47999999992;19.5;72.21254663999999;2251.68254664;1040.4;304085.82264609955;522988.98915339774;295905.5091533978;264526.16980419395
694.44;1461.06;226389.03999999992;19.5;71.99171471999998;2246.99171472;1040.4;305721.5782236711;523724.1792998147;297335.13929981476;265911.68854182586
694.44;1456.59;225694.59999999992;19.5;71.77088279999998;2242.3008827999997;1061.21;307334.09657992783;524460.4029374955;298765.8029374956;267298.17876124586
694.44;1452.12;225000.15999999992;19.5;71.55005087999999;2237.61005088;1061.21;308944.18430281087;525197.6615192674;300197.50151926745;268685.64182811143
694.44;1447.66;224305.7199999999;19.5;71.32921895999998;2232.9292189600005;1061.21;310458.6824351256;525935.9564999996;301630.2364999997;270074.07910999976
694.44;1443.19;223611.2799999999;19.5;71.10838703999998;2228.23838704;1061.21;312063.77769683825;526675.289336607;303064.00933660707;271463.4919764107
694.44;1438.72;222916.8399999999;19.5;70.88755511999997;2223.5475551199997;1061.21;313666.43189018517;527415.661488052;304498.8214880521;272853.88179876894
694.44;1434.25;222222.3999999999;19.5;70.66672319999998;2218.8567232;1061.21;315266.641583642;528157.0744153484;305934.67441534845;274245.24995042756
694.44;1429.78;221527.9599999999;19.5;70.44589127999998;2214.1658912800003;1061.21;316864.40334086074;528899.5295815635;307371.56958156364;275637.59780666983
694.44;1425.32;220833.5199999999;19.5;70.22505935999997;2209.4850593600004;1061.21;318459.72373472;529643.0284518215;308809.50845182163;277030.92674471234
694.44;1420.85;220139.0799999999;19.5;70.00422743999998;2204.7942274399998;1061.21;320052.5893192234;530387.5724933061;310248.4924933062;278425.23814370786
694.44;1416.38;219444.6399999999;19.5;69.78339551999997;2200.10339552;1061.21;321642.9966435303;531133.1631752636;311688.52317526366;279820.53338474786
694.44;1411.91;218750.1999999999;19.5;69.56256359999998;2195.4125636000003;1061.21;323230.94225194905;531879.8019690054;313129.6019690055;281216.8138508652
694.44;1407.44;218055.7599999999;19.5;69.34173167999997;2190.72173168;1082.43;324795.17285398114;532627.4903479115;314571.7303479116;282614.08092703694
694.44;1402.98;217361.3199999999;19.5;69.12089975999997;2186.0408997600002;1082.43;326356.91495633655;533376.2297874329;316014.90978743305;284012.3360001871
694.44;1398.51;216666.8799999999;19.5;68.90006783999998;2181.3500678399996;1082.43;327916.1550467572;534126.021765095;317459.14176509506;285411.58045918937
694.44;1394.04;215972.4399999999;19.5;68.67923591999997;2176.65923592;1082.43;329374.0477411651;534876.8677604997;318904.4277604998;286811.81569486985
694.44;1389.57;215277.99999999988;19.5;68.45840399999997;2171.968404;1082.43;330928.1343045381;535628.7692553294;320350.7692553295;288213.04310000973
694.44;1385.1;214583.55999999988;19.5;68.23757207999996;2167.27757208;1082.43;332479.7080942261;536381.727733349;321798.1677333491;289615.26406934817
694.44;1380.64;213889.11999999988;19.5;68.01674015999997;2162.59674016;1082.43;334028.77559196285;537135.7446804094;323246.62468040956;291018.479999585
694.44;1376.17;213194.67999999988;19.5;67.79590823999997;2157.90590824;1082.43;335575.32326047873;537890.8215844502;324696.1415844503;292422.6922893833
694.44;1371.7;212500.23999999987;19.5;67.57507631999997;2153.21507632;1082.43;337119.3475575316;538646.9599355026;326146.71993550274;293827.9023393726
694.44;1367.23;211805.79999999987;19.5;67.35424439999997;2148.5242444;1082.43;338660.8449358999;539404.1612256925;327598.3612256926;295234.11155215104
694.44;1362.76;211111.35999999987;19.5;67.13341247999996;2143.83341248;1082.43;340199.81184337556;540162.4269492432;329051.0669492433;296641.32133228873
694.44;1358.3;210416.91999999987;19.5;66.91258055999997;2139.15258056;1104.08;341714.57430239423;540921.7586024785;330504.8386024787;298049.53308633
694.44;1353.83;209722.47999999986;19.5;66.69174863999996;2134.4617486399998;1104.08;343226.7687079904;541682.157683826;331959.6776838262;299458.7482227966
694.44;1349.36;209028.03999999986;19.5;66.47091671999996;2129.77091672;1104.08;344736.3914501311;542443.6256938194;333415.5856938195;300868.9681521903
694.44;1344.89;208333.59999999986;19.5;66.25008479999997;2125.0800848;1104.08;346243.4389137082;543206.1641351016;334872.56413510174;302280.1942869956
694.44;1340.42;207639.15999999986;19.5;91.15359123999994;2145.51359124;1104.08;347668.73521521204;543969.7745124282;336330.61451242835;303692.42804168264
694.44;1335.95;206944.71999999986;19.5;90.84873207999993;2140.7387320800003;1104.08;349195.58547130006;544734.4583326699;337789.73833267007;305105.6708327099
694.44;1331.49;206250.27999999985;19.5;90.54387291999993;2135.97387292;1104.08;350719.8105350452;545500.2171048159;339249.937104816;306519.9240785271
694.44;1327.02;205555.83999999985;19.5;90.23901375999993;2131.19901376;1104.08;352241.39670203405;546267.0523399763;340711.21233997645;307935.1891995779
694.44;1322.55;204861.39999999985;19.5;89.93415459999993;2126.4241546;1104.08;353760.3402626457;547034.9655513858;342173.5655513859;309351.4676183028
694.44;1318.08;204166.95999999985;19.5;89.62929543999994;2121.64929544;1104.08;355276.6375020444;547803.9582544061;343636.99825440627;310768.7607591419
694.44;1313.61;203472.51999999984;19.5;89.32443627999993;2116.87443628;1104.08;356790.2847001723;548574.0319665292;345101.51196652936;312187.07004853763
694.44;1309.15;202778.07999999984;19.5;89.01957711999992;2112.1095771200003;1126.16;358279.17710690835;549345.1882073802;346567.1082073804;313606.3969149376
694.44;1304.68;202083.63999999984;19.5;88.71471795999993;2107.33471796;1126.16;359765.38094811526;550117.4284987206;348033.7884987208;315026.74278879754
694.44;1300.21;201389.19999999984;19.5;88.40985879999992;2102.5598588;1126.16;361248.89244435047;550890.754364451;349501.5543644512;316448.10910258413
694.44;1295.74;200694.75999999983;19.5;88.10499963999993;2097.78499964;1126.16;362729.7078108583;551665.1673306142;350970.40733061434;317870.4972907775
694.44;1291.27;200000.31999999983;19.5;87.80014047999992;2093.01014048;1126.16;364207.8232575629;552440.6689253981;352440.3489253983;319293.9087898744
694.44;1286.81;199305.87999999983;19.5;87.49528131999992;2088.24528132;1126.16;365573.5400296168;553217.2606791393;353911.38067913946;320718.3450383911
694.44;1282.34;198611.43999999983;19.5;87.19042215999993;2083.47042216;1126.16;367046.1000558769;553994.9441243252;355383.50412432535;322143.8074768658
694.44;1277.87;197916.99999999983;19.5;86.88556299999992;2078.6955629999998;1126.16;368515.94855741475;554773.7207955976;356856.7207955978;323570.29754786193
694.44;1273.4;197222.55999999982;19.5;86.58070383999993;2073.92070384;1126.16;369983.08172251296;555553.5922297558;358331.032229756;324997.81669597066
694.44;1268.93;196528.11999999982;19.5;86.27584467999992;2069.14584468;1126.16;371447.49573409575;556334.5599657593;359806.43996575946;326426.3663678139
694.44;1264.47;195833.67999999982;19.5;85.97098551999991;2064.38098552;1126.16;372909.19678377896;557116.6255447309;361282.9455447311;327855.9480120473
694.44;1260.0;195139.23999999982;19.5;85.66612635999992;2059.60612636;1148.69;374345.6093722899;557899.79050996;362760.5505099602;329286.5630793626
694.44;1255.53;194444.7999999998;19.5;85.36126719999992;2054.8312671999997;1148.69;375779.25962193037;558684.0564069055;364239.2564069057;330718.21302249137
694.44;1251.06;193750.3599999998;19.5;85.05640803999991;2050.05640804;1148.69;377210.143649551;559469.4247831987;365719.06478319893;332150.899296207
694.44;1246.59;193055.9199999998;19.5;84.75154887999992;2045.28154888;1148.69;378638.2575665439;560255.8971886465;367199.9771886467;333584.6233573279
694.44;1242.13;192361.4799999998;19.5;84.44668971999991;2040.5166897200002;1148.69;380063.607492892;561043.4751752344;368681.99517523457;335019.3866647205
694.44;1237.66;191667.0399999998;19.5;84.14183055999992;2035.7418305600002;1148.69;381486.1795290667;561832.1602971297;370165.12029712985;336455.1906793021
694.44;1233.19;190972.5999999998;19.5;83.83697139999991;2030.9669714;1148.69;382791.09797912644;562621.9541106845;371649.35411068465;337892.03686404356
694.44;1228.72;190278.1599999998;19.5;83.5321122399999;2026.19211224;1148.69;384207.94103377016;563412.8581744385;373134.6981744387;339329.92668397236
694.44;1224.25;189583.7199999998;19.5;83.22725307999991;2021.41725308;1148.69;385621.9942397319;564204.8740491226;374621.15404912276;340768.86160617543
694.44;1219.78;188889.2799999998;19.5;82.9223939199999;2016.64239392;1148.69;387033.2536751907;564998.0032976614;376108.72329766164;342208.843099802
694.44;1215.32;188194.8399999998;19.5;82.61753475999991;2011.87753476;1148.69;388441.72542686964;565792.2474851769;377597.4074851771;343649.8726360665
694.44;1210.85;187500.3999999998;19.5;82.3126755999999;2007.1026755999999;1171.66;389824.39327192743;566587.608178991;379087.2081789912;345091.95168825175
694.44;1206.38;186805.9599999998;19.5;82.0078164399999;2002.32781644;1171.66;391204.22322660865;567384.0869486291;380578.12694862933;346535.0817317116
694.44;1201.91;186111.5199999998;19.5;81.70295727999991;1997.55295728;1171.66;392581.21130155766;568181.6853658227;382070.16536582296;347979.2642438736
694.44;1197.44;185417.07999999978;19.5;81.3980981199999;1992.77809812;1171.66;393955.35350181087;568980.4050045129;383563.3250045131;349424.5007042423
694.44;1192.98;184722.63999999978;19.5;81.09323895999991;1988.01323896;1171.66;395326.65584084624;569780.2474408533;385057.6074408535;350870.7925944023
694.44;1188.51;184028.19999999978;19.5;80.7883797999999;1983.2383797999998;1171.66;396695.1043124803;570581.2142532131;386553.01425321336;352318.14139802055
694.44;1184.04;183333.75999999978;19.5;80.4835206399999;1978.4635206399998;1171.66;398060.6949048977;571383.3070221806;388049.54702218086;353766.54860085004
694.44;1179.57;182639.31999999977;19.5;80.1786614799999;1973.6886614799998;1171.66;399303.5965735635;572186.5273305658;389547.2073305661;355216.0156907321
694.44;1175.1;181944.87999999977;19.5;79.8738023199999;1968.9138023199998;1171.66;400663.2909030647;572990.8767634036;391045.9967634039;356666.5441575997
694.44;1170.64;181250.43999999977;19.5;79.5689431599999;1964.14894316;1171.66;402020.12506129866;573796.3569079573;392545.9169079576;358118.13549348013
694.44;1166.17;180555.99999999977;19.5;79.2640839999999;1959.374084;1171.66;403374.08501353103;574602.9693537214;394046.9693537216;359570.7911924983
694.44;1161.7;179861.55999999976;19.5;78.95922483999989;1954.59922484;1195.09;404701.70378270594;575410.7156924247;395549.1556924249;361024.51275087945
694.44;1157.23;179167.11999999976;19.5;78.6543656799999;1949.82436568;1195.09;406026.4072764369;576219.5975180337;397052.47751803393;362479.3016669519
694.44;1152.76;178472.67999999976;19.5;78.34950651999989;1945.04950652;1195.09;407348.1913965845;577029.6164267556;398556.9364267558;363935.1594411505
694.44;1148.3;177778.23999999976;19.5;78.04464735999989;1940.2846473599998;1195.09;408667.06205330585;577840.7740170414;400062.5340170417;365392.08757601917
694.44;1143.83;177083.79999999976;19.5;77.7397881999999;1935.5097881999998;1195.09;409983.00513695134;578653.0718895893;401569.27188958955;366850.0875762142
694.44;1139.36;176389.35999999975;19.5;77.43492903999989;1930.7349290399998;1195.09;411296.01653209416;579466.5116473475;403077.1516473477;368309.1609485069
694.44;1134.89;175694.91999999975;19.5;77.1300698799999;1925.96006988;1195.09;412606.0921175224;580281.0948955176;404586.1748955178;369769.30920178676
694.44;1130.42;175000.47999999975;19.5;76.82521071999989;1921.18521072;1195.09;413913.2277662306;581096.8232415576;406096.3432415578;371230.53384706436
694.44;1125.96;174306.03999999975;19.5;76.52035155999988;1916.42035156;1195.09;415092.86413066153;581913.6982951853;407607.6582951856;372692.83639747446
694.44;1121.49;173611.59999999974;19.5;76.21549239999989;1911.6454924;1195.09;416393.9424226507;582731.7216683815;409120.12166838173;374156.2183682788
694.44;1117.02;172917.15999999974;19.5;75.91063323999988;1906.87063324;1195.09;417692.06813000253;583550.8949753926;410633.7349753929;375620.6812768693
694.44;1112.55;172222.71999999974;19.5;75.60577407999989;1902.09577408;1218.99;418963.3035047796;584371.2198327347;412148.49983273493;377086.22664277087
694.44;1108.08;171528.27999999974;19.5;75.30091491999988;1897.32091492;1218.99;420231.54434333125;585192.6978591959;413664.41785919614;378552.8559876444
694.44;1103.61;170833.83999999973;19.5;74.99605575999988;1892.54605576;1218.99;421496.78643609746;586015.3306758403;415181.4906758405;380020.5708352901
694.44;1099.15;170139.39999999973;19.5;74.69119659999988;1887.7811966;1218.99;422759.0355816581;586839.1199060105;416699.7199060107;381489.3727116501
694.44;1094.68;169444.95999999973;19.5;74.38633743999988;1883.00633744;1218.99;424018.2775586295;587664.0671753312;418219.10717533145;382959.26314481156
694.44;1090.21;168750.51999999973;19.5;74.08147827999989;1878.23147828;1218.99;425274.50813969376;588490.1741117124;419739.65411171265;384430.2436650099
694.44;1085.74;168056.07999999973;19.5;73.77661911999988;1873.45661912;1218.99;426527.72309159045;589317.4423453525;421261.36234535277;385902.3158046316
694.44;1081.27;167361.63999999972;19.5;73.47175995999987;1868.68175996;1218.99;427777.91817510827;590145.8735087414;422784.23350874166;387375.4810982172
694.44;1076.81;166667.19999999972;19.5;73.16690079999988;1863.9169008;1218.99;429025.099159134;590975.469236664;424308.2692366643;388849.74108246446
694.44;1072.34;165972.75999999972;19.5;118.3385778799998;1904.6185778799997;1218.99;430185.6978196116;591806.2311662034;425833.4711662037;390325.0972962315
694.44;1067.87;165278.31999999972;19.5;117.8434421599998;1899.6534421599997;1218.99;431472.05031028285;592638.1609367438;427359.8409367441;391801.5512805395
694.44;1063.4;164583.8799999997;19.5;117.34830643999979;1894.68830644;1243.37;432730.82469941746;593471.2601899741;428887.3801899744;393279.10457857593
694.44;1058.93;163889.4399999997;19.5;116.85317071999981;1889.7231707199999;1243.37;433986.396491294;594305.530569891;430416.09056989127;394757.75873569783
694.44;1054.47;163194.9999999997;19.5;116.35803499999979;1884.7680349999998;1243.37;435238.771197929;595140.973722802;431945.9737228023;396237.5152994342
694.44;1050.0;162500.5599999997;19.5;115.8628992799998;1879.8028992799998;1243.37;436487.93431097217;595977.5912973293;433477.0312973296;397718.3758194898
694.44;1045.53;161806.1199999997;19.5;115.36776355999979;1874.8377635599998;1243.37;437733.88131573587;596815.3849444124;435009.2649444127;399200.3418477479
694.44;1041.06;161111.6799999997;19.5;114.87262783999978;1869.8726278399997;1243.37;438976.60769118584;597654.3563173115;436542.6763173118;400683.41493827314
694.44;1036.59;160417.2399999997;19.5;114.37749211999979;1864.9074921199997;1243.37;440216.1089099325;598494.5070716112;438077.26707161154;402167.59664731484
694.44;1032.13;159722.7999999997;19.5;113.88235639999976;1859.9523563999999;1243.37;441452.39045227924;599335.8388652232;439613.0388652235;403652.88853331015
694.44;1027.66;159028.3599999997;19.5;113.38722067999979;1854.9872206799998;1243.37;442685.43777811853;600178.3533583898;441149.9933583901;405139.2921568867
694.44;1023.19;158333.9199999997;19.5;112.89208495999978;1850.0220849599998;1243.37;443915.2463409606;601022.0522136872;442688.1322136875;406626.8090808663
694.44;1018.72;157639.4799999997;19.5;112.39694923999977;1845.0569492399998;1243.37;445008.26904444804;601866.9370960288;444227.45709602913;408115.4408702674
694.44;1014.25;156945.0399999997;19.5;111.90181351999978;1840.0918135199997;1268.24;446206.49372831156;602713.0096726684;445767.9696726687;409605.18909230863
694.44;1009.79;156250.5999999997;19.5;111.40667779999978;1835.1366777999997;1268.24;447401.4407114145;603560.2716132037;447309.671613204;411096.0553164118
694.44;1005.32;155556.15999999968;19.5;110.91154207999978;1830.17154208;1268.24;448593.0953720818;604408.7245895792;448852.5645895795;412588.04111420474
694.44;1000.85;154861.71999999968;19.5;110.41640635999977;1825.2064063599996;1268.24;449781.45308214135;605258.3702760898;450396.6502760901;414081.1480595247
694.44;996.38;154167.27999999968;19.5;109.92127063999976;1820.24127064;1268.24;450966.50920691516;606109.210349384;451941.9303493843;415575.3777284213
694.44;991.91;153472.83999999968;19.5;109.42613491999977;1815.2761349199998;1268.24;452148.2591052099;606961.2464884674;453488.40648846776;417070.7316991597
694.44;987.44;152778.39999999967;19.5;108.93099919999976;1810.3109992;1268.24;453326.698129308;607814.4803747059;455036.0803747062;418567.21155222383
694.44;982.98;152083.95999999967;19.5;108.43586347999977;1805.35586348;1268.24;454501.8316390159;608668.9136918286;456584.95369182894;420064.8188703192
694.44;978.51;151389.51999999967;19.5;107.94072775999976;1800.39072776;1268.24;455673.64497355936;609524.548125932;458135.0281259323;421563.55523837643
694.44;974.04;150695.07999999967;19.5;107.44559203999977;1795.4255920399999;1268.24;456842.1334656126;610381.3853654824;459686.30536548275;423063.4222435538
694.44;969.57;150000.63999999966;19.5;106.95045631999974;1790.46045632;1268.24;458007.29244128853;611239.4271013199;461238.7871013202;424564.421475241
694.44;965.1;149306.19999999966;19.5;106.45532059999975;1785.4953205999998;1293.61;459005.9684428644;612098.6750266613;462792.4750266616;426066.5545250619
694.44;960.64;148611.75999999966;19.5;105.96018487999976;1780.5401848799997;1293.61;460138.82934220653;612959.1308371037;464347.37083710404;427569.8229868778
694.44;956.17;147917.31999999966;19.5;105.46504915999975;1775.57504916;1293.61;461268.31064179365;613820.796230628;465903.4762306284;429074.2284567907
694.44;951.7;147222.87999999966;19.5;104.96991343999976;1770.60991344;1293.61;462394.40759076393;614683.6729076018;467460.79290760215;430579.772533146
694.44;947.23;146528.43999999965;19.5;104.47477771999975;1765.6447777199999;1293.61;463517.11543157697;615547.762570783;469019.3225707834;432086.4568165364
694.44;942.76;145833.99999999965;19.5;103.97964199999974;1760.6796419999998;1293.61;464636.42940000456;616413.0669253233;470579.0669253237;433594.28290980426
694.44;938.3;145139.55999999965;19.5;103.48450627999975;1755.7245062799998;1293.61;465752.35473917855;617279.5876787712;472140.0276787716;435103.2524180453
694.44;933.83;144445.11999999965;19.5;102.98937055999974;1750.7593705599998;1293.61;466864.8766714865;618147.3265410757;473702.20654107607;436613.3669486115
694.44;929.36;143750.67999999964;19.5;102.49423483999975;1745.79423484;1293.61;467973.9904125997;619016.2852245896;475265.60522459;438124.6281111146
694.44;924.89;143056.23999999964;19.5;101.99909911999974;1740.8290991199997;1293.61;469079.69117146404;619886.4654440727;476830.2254440731;439637.03751742875
694.44;920.42;142361.79999999964;19.5;101.50396339999973;1735.8639633999999;1293.61;470181.9741502903;620757.8689166955;478396.06891669583;441150.5967816941
694.44;915.96;141667.35999999964;19.5;101.00882767999974;1730.9088276799998;1319.48;471254.9381919301;621630.4973620421;479963.13736204244;442665.30752031994
694.44;911.49;140972.91999999963;19.5;100.51369195999973;1725.9436919599998;1319.48;472182.74110246316;622504.3525021143;481531.4325021146;444181.17135198775
694.44;907.02;140278.47999999963;19.5;100.01855623999974;1720.9785562399998;1319.48;473248.5734851408;623379.4360613342;483100.9560613346;445698.1898976545
694.44;902.55;139584.03999999963;19.5;99.52342051999973;1716.0134205199997;1319.48;474310.93204293447;624255.7497665484;484671.70976654877;447216.3647805559
694.44;898.08;138889.59999999963;19.5;99.02828479999974;1711.0482847999997;1319.48;475369.8118925255;625133.2953470307;486243.6953470311;448735.6976262093
694.44;893.62;138195.15999999963;19.5;98.53314907999973;1706.0931490799996;1319.48;476425.2181577883;626012.074534486;487816.9145344864;450256.19006241724
694.44;889.15;137500.71999999962;19.5;98.03801335999972;1701.1280133599998;1319.48;477477.13594168477;626892.0890630535;489391.36906305386;451777.84371927066
694.44;884.68;136806.27999999962;19.5;97.54287763999973;1696.1628776399996;1319.48;478525.5603402933;627773.34066931;490967.06066931033;453300.6602291517
694.44;880.21;136111.83999999962;19.5;97.04774191999972;1691.1977419199998;1319.48;479570.4864427982;628655.8310922737;492543.9910922741;454824.64122673764
694.44;875.74;135417.39999999962;19.5;96.55260619999973;1686.2326061999997;1319.48;480611.9093314808;629539.5620734073;494122.16207340773;456349.7883490033
694.44;871.27;134722.9599999996;19.5;96.05747047999972;1681.2674704799997;1319.48;481649.824081709;630424.5353566217;495701.5753566221;457876.1032352248
694.44;866.81;134028.5199999996;19.5;95.56233475999971;1676.3123347599997;1345.87;482657.8086783251;631310.752688279;497282.2326882794;459403.58752698265
694.44;862.34;133334.0799999996;19.5;95.06719903999972;1671.3471990399999;1345.87;483662.23813071166;632198.2158171965;498864.1358171969;460932.24286816514
694.44;857.87;132639.6399999996;19.5;94.57206331999971;1666.3820633199996;1345.87;484517.70850900334;633086.92649465;500447.28649465035;462462.07090497133
694.44;853.4;131945.1999999996;19.5;94.07692759999972;1661.4169275999998;1345.87;485514.80827890936;633976.8864743767;502031.68647437706;463993.07328591443
694.44;848.93;131250.7599999996;19.5;93.58179187999971;1656.4517918799995;1345.87;486508.33760327456;634868.0975125795;503617.3375125799;465525.25166182517
694.44;844.47;130556.3199999996;19.5;93.0866561599997;1651.4966561599997;1345.87;487498.3014770136;635760.56136793;505204.24136793043;467058.60768585466
694.44;840.0;129861.8799999996;19.5;92.59152043999971;1646.5315204399997;1345.87;488484.684873948;636654.2798015721;506792.3998015725;468593.14301347814
694.44;835.53;129167.4399999996;19.5;92.0963847199997;1641.5663847199996;1345.87;489467.48276083346;637549.2545771252;508381.8145771256;470128.8593024981
694.44;831.06;128472.99999999959;19.5;91.60124899999971;1636.6012489999998;1345.87;490446.69009735045;638445.4874606881;509972.4874606885;471665.75821304723
694.44;826.59;127778.55999999959;19.5;91.1061132799997;1631.6361132799998;1345.87;491422.301836094;639342.9802208422;511564.4202208426;473203.84140759206
694.44;822.13;127084.11999999959;19.5;90.61097755999971;1626.68097756;1345.87;492394.3229366211;640241.734628655;513157.6146286554;474743.11055093614
694.44;817.66;126389.67999999959;19.5;90.1158418399997;1621.7158418399997;1372.79;493335.7804946394;641141.752457684;514752.07245768444;476283.5673102234
694.44;813.19;125695.23999999958;19.5;89.6207061199997;1616.75070612;1372.79;494273.58938825043;642043.0354839795;516347.7954839799;477825.21335494117
694.44;808.72;125000.79999999958;19.5;89.1255703999997;1611.7855703999999;1372.79;495207.7444883554;642945.5854860886;517944.78548608907;479368.0503569237
694.44;804.25;124306.35999999958;19.5;174.65043579999943;1692.8404357999996;1372.79;496075.51426764025;643849.4042450588;519543.0442450592;480912.07999035565
694.44;799.79;123611.91999999958;19.5;173.67474759999942;1687.4047475999994;1372.79;497087.9278966687;644754.4935444408;521142.57354444126;482457.3039317748
694.44;795.32;122917.47999999957;19.5;172.69905939999944;1681.9590593999997;1372.79;498096.3113795511;645660.8551702931;522743.37517029356;484003.723860076
694.44;790.85;122223.03999999957;19.5;171.72337119999943;1676.5133711999995;1372.79;499100.65905092185;646568.4909111847;524345.4509111851;485551.341456514
694.44;786.38;121528.59999999957;19.5;170.74768299999943;1671.0676829999995;1372.79;500100.9652374516;647477.4025581987;525948.802558199;487100.1584047071
694.44;781.91;120834.15999999957;19.5;169.77199479999942;1665.6219947999994;1372.79;501097.22425783554;648387.5919049361;527553.4319049366;488650.1763906404
694.44;777.45;120139.71999999956;19.5;168.7963065999994;1660.1863065999996;1372.79;502089.4404368399;649299.0607475196;529159.3407475201;490201.39710266894
694.44;772.98;119445.27999999956;19.5;167.8206183999994;1654.7406183999994;1372.79;503077.5980771955;650211.8108845963;530766.5308845968;491753.82223152096
694.44;768.51;118750.83999999956;19.5;166.8449301999994;1649.2949301999995;1400.24;504034.2028858721;651125.844117342;532375.0041173424;493307.4534703019
694.44;764.04;118056.39999999956;19.5;165.86924199999942;1643.8492419999993;1400.24;504986.6990953267;652041.1622494645;533984.762249465;494862.2925144971
694.44;759.57;117361.95999999956;19.5;164.8935537999994;1638.4035537999996;1400.24;505935.08092990884;652957.7670872071;535595.8070872074;496418.341061975
694.44;755.1;116667.51999999955;19.5;163.9178655999994;1632.9578655999994;1400.24;506879.34260584874;653875.660439352;537208.1404393525;497975.6008129914
694.44;750.64;115973.07999999955;19.5;162.9421773999994;1627.5221773999992;1400.24;507667.1424988001;654794.8441172247;538821.7641172251;499534.07347019156
694.44;746.17;115278.63999999955;19.5;161.9664891999994;1622.0764891999995;1400.24;508602.9423420474;655715.3199346963;540436.6799346968;501093.760738615
694.44;741.7;114584.19999999955;19.5;160.99080099999938;1616.6308009999996;1400.24;509534.60433955723;656637.0897081881;542052.8897081886;502654.6643256973
694.44;737.23;113889.75999999954;19.5;160.01511279999937;1611.1851127999994;1400.24;510462.1226745658;657560.1552566747;543670.3952566752;504216.7859412747
694.44;732.76;113195.31999999954;19.5;159.0394245999994;1605.7394245999994;1400.24;511385.49152213254;658484.518401688;545289.1984016884;505780.1272975871
694.44;728.3;112500.87999999954;19.5;158.06373639999939;1600.3037363999995;1400.24;512304.7150631857;659410.18096732;546909.3009673205;507344.6901092813
694.44;723.83;111806.43999999954;19.5;157.08804819999938;1594.8580481999993;1400.24;513219.77745641617;660337.1447802273;548530.7047802277;508910.4760934141
694.44;719.36;111111.99999999953;19.5;156.11235999999937;1589.4123599999996;1428.25;514102.6234773328;661265.4116696343;550153.4116696347;510477.4869694567
694.44;714.89;110417.55999999953;19.5;155.13667179999936;1583.9666717999994;1428.25;514981.25721284084;662194.9834673366;551777.4234673372;512045.72445929697
694.44;710.42;109723.11999999953;19.5;154.16098359999935;1578.5209835999995;1428.25;515855.6727415331;663125.8620077051;553402.7420077056;513615.1902872433
694.44;705.96;109028.67999999953;19.5;153.18529539999935;1573.0852953999995;1428.25;516725.8741477359;664058.0491276893;555029.3691276899;515185.8861800285
694.44;701.49;108334.23999999953;19.5;152.20960719999937;1567.6396071999993;1428.25;517591.8454934022;664991.5466668208;556657.3066668212;516757.813866812
694.44;697.02;107639.79999999952;19.5;151.23391899999936;1562.1939189999994;1428.25;518298.044757888;665926.3564672172;558286.5564672176;518330.9750791846
694.44;692.55;106945.35999999952;19.5;150.25823079999935;1556.7482307999994;1428.25;519155.3194905858;666862.4803735858;559917.1203735863;519905.3715511712
694.44;688.08;106250.91999999952;19.5;149.28254259999935;1551.3025425999992;1428.25;520008.3459911161;667799.920233227;561549.0002332274;521481.0050192338
694.44;683.62;105556.47999999952;19.5;148.30685439999934;1545.8668543999993;1428.25;520857.128301597;668738.6778960379;563182.1978960384;523057.8772222761
694.44;679.15;104862.03999999951;19.5;147.33116619999933;1540.4211661999996;1428.25;521701.6504417143;669678.7552145164;564816.715214517;524635.989901646
694.44;674.68;104167.59999999951;19.5;146.35547799999932;1534.9754779999992;1428.25;522541.90642274654;670620.1540437642;566452.5540437647;526215.3448011389
694.44;670.21;103473.15999999951;19.5;145.37978979999934;1529.5297897999994;1456.81;523349.2900994227;671562.8762414911;568089.7162414915;527795.943667002
694.44;665.74;102778.7199999995;19.5;144.40410159999934;1524.0841015999995;1456.81;524152.35540973424;672506.923668018;569728.2036680185;529377.7882479373
694.44;661.28;102084.2799999995;19.5;143.42841339999933;1518.6484133999993;1456.81;524951.1062972086;673452.2981862812;571368.0181862817;530960.8802951048
694.44;656.81;101389.8399999995;19.5;142.45272519999932;1513.2027251999993;1456.81;525745.5266828018;674399.001661836;573009.1616618366;532545.2215621264
694.44;652.34;100695.3999999995;19.5;141.4770369999993;1507.7570369999994;1456.81;526535.6104789242;675347.0359628599;574651.6359628604;534130.8138050889
694.44;647.87;100000.9599999995;19.5;140.5013487999993;1502.3113487999992;1456.81;527321.3515894288;676296.4029601566;576295.4429601571;535717.6587825477
694.44;643.4;99306.5199999995;19.5;139.5256605999993;1496.8656605999995;1456.81;527944.3130864258;677247.1045271597;577940.5845271603;537305.7582555307
694.44;638.93;98612.07999999949;19.5;138.54997239999932;1491.419972399999;1456.81;528721.1277893251;678199.1425399366;579587.0625399371;538895.113987541
694.44;634.47;97917.63999999949;19.5;137.5742841999993;1485.9842841999994;1456.81;529493.5911676773;679152.5188771917;581234.8788771923;540485.7277445608
694.44;630.0;97223.19999999949;19.5;136.5985959999993;1480.5385959999994;1456.81;530261.6870905642;680107.2354202705;582884.035420271;542077.6012950548
694.44;625.53;96528.75999999949;19.5;135.6229077999993;1475.0929077999992;1456.81;531025.4094184487;681063.294053163;584534.5340531636;543670.7364099738
694.44;621.06;95834.31999999948;19.5;134.6472195999993;1469.6472195999993;1485.95;531755.5710396988;682020.6966625081;586186.3766625086;545265.1348627581
694.44;616.59;95139.87999999948;19.5;133.67153139999928;1464.2015313999996;1485.95;532481.3057399199;682979.4451375962;587839.5651375968;546860.798429341
694.44;612.13;94445.43999999948;19.5;132.69584319999927;1458.7658431999994;1485.95;533202.6173100389;683939.5413703742;589494.1013703747;548457.7288881522
694.44;607.66;93750.99999999948;19.5;131.7201549999993;1453.3201549999992;1485.95;533919.489518197;684900.9872554479;591149.9872554485;550055.9280201216
694.44;603.19;93056.55999999947;19.5;130.7444667999993;1447.8744667999995;1485.95;534631.9161237748;685863.7846900871;592807.2246900876;551655.3976086824
694.44;598.72;92362.11999999947;19.5;129.76877859999928;1442.4287785999993;1485.95;535339.8908773805;686827.9355742284;594465.815574229;553256.1394397753
694.44;594.25;91667.67999999947;19.5;128.79309039999927;1436.9830903999994;1485.95;536043.407520837;687793.4418104792;596125.7618104797;554858.155301851
694.44;589.79;90973.23999999947;19.5;127.81740219999926;1431.5474021999994;1485.95;536581.4470602868;688760.3053041213;597787.0653041219;556461.4469858747
694.44;585.32;90278.79999999946;19.5;126.84171399999926;1426.1017139999994;1485.95;537275.8123446284;689728.5279631155;599449.727963116;558066.0162853291
694.44;580.85;89584.35999999946;19.5;125.86602579999926;1420.6560257999993;1485.95;537965.7003873516;690698.1116981038;601113.7516981044;559671.8649962182
694.44;576.38;88889.91999999946;19.5;124.89033759999926;1415.2103375999993;1485.95;538651.1048945879;691669.0584224149;602779.1384224155;561278.9949170706
694.44;571.91;88195.47999999946;19.5;123.91464939999926;1409.7646493999991;1515.67;539302.2577848235;692641.3700520666;604445.8900520671;562887.4078489431
694.44;567.45;87501.03999999946;19.5;122.93896119999926;1404.3289611999994;1515.67;539948.8827018095;693615.0485057705;606114.008505771;564497.1055954248
694.44;562.98;86806.59999999945;19.5;121.96327299999925;1398.8832729999992;1515.67;540590.963266304;694590.0957049351;607783.4957049356;566108.0899626395
694.44;558.51;86112.15999999945;19.5;120.98758479999924;1393.4375847999993;1515.67;541228.4930900977;695566.5135736703;609454.3535736708;567720.3627592507
694.44;554.04;85417.71999999945;19.5;120.01189659999923;1387.9918965999993;1515.67;541861.4657760009;696544.3040387903;611126.5840387908;569333.9257964634
694.44;549.57;84723.27999999945;19.5;119.03620839999924;1382.5462083999994;1515.67;542489.8749178312;697523.4690298184;612800.189029819;570948.7808880298
694.44;545.11;84028.83999999944;19.5;118.06052019999923;1377.1105201999994;1515.67;543113.7241144581;698504.0104789902;614475.1704789908;572564.9298502514
694.44;540.64;83334.39999999944;19.5;117.08483199999924;1371.6648319999993;1515.67;543732.9969416955;699485.9303212572;616151.5303212578;574182.3745019824
694.44;536.17;82639.95999999944;19.5;183.79127103999875;1433.9012710399988;1515.67;544252.139598235;700469.2304942914;617829.270494292;575801.1166646346
694.44;531.7;81945.51999999944;19.5;182.24683647999873;1427.886836479999;1515.67;544929.3137878893;701453.9129384884;619508.392938489;577421.1581621796
694.44;527.23;81251.07999999943;19.5;180.70240191999872;1421.8724019199988;1515.67;545601.417023724;702439.9795969717;621188.8995969722;579042.5008211539
694.44;522.76;80556.63999999943;19.5;179.15796735999874;1415.8579673599988;1545.98;546238.0895690728;703427.432415596;622870.7924155965;580665.1464706608
694.44;518.3;79862.19999999943;19.5;177.61353279999872;1409.8535327999987;1545.98;546869.6442395989;704416.2733429518;624554.0733429524;582289.0969423753
694.44;513.83;79167.75999999943;19.5;176.0690982399987;1403.8390982399987;1545.98;547496.0638268079;705406.5043303686;626238.7443303692;583914.354070547
694.44;509.36;78473.31999999942;19.5;174.5246636799987;1397.8246636799988;1545.98;548117.3411120723;706398.127331919;627924.8073319197;585540.9196920046
694.44;504.89;77778.87999999942;19.5;172.9802291199987;1391.8102291199987;1545.98;548733.4688666174;707391.1443044227;629612.2643044232;587168.7956461579
694.44;500.42;77084.43999999942;19.5;171.4357945599987;1385.7957945599987;1545.98;549344.4398515063;708385.5572074498;631301.1172074503;588797.9837750033
694.44;495.96;76389.99999999942;19.5;169.89135999999868;1379.7913599999988;1545.98;549950.2568316835;709381.3680033254;632991.368003326;590428.4859231265
694.44;491.49;75695.55999999942;19.5;168.3469254399987;1373.7769254399986;1545.98;550550.9025478653;710378.578657133;634683.0186571337;592060.3039377057
694.44;487.02;75001.11999999941;19.5;166.8024908799987;1367.7624908799987;1545.98;551146.3697305636;711377.1911367186;636376.0711367192;593693.439668516
694.44;482.55;74306.67999999941;19.5;165.25805631999867;1361.7480563199988;1545.98;551571.1301047411;712377.2074126943;638070.5274126949;595327.8949679332
694.44;478.08;73612.23999999941;19.5;163.71362175999866;1355.7336217599986;1545.98;552155.9856904919;713378.6294584427;639766.3894584433;596963.6716909367
694.44;473.62;72917.7999999994;19.5;162.16918719999867;1349.7291871999987;1576.9;552704.687094196;714381.4592501201;641463.6592501206;598600.7716951134
694.44;469.15;72223.3599999994;19.5;160.62475263999866;1343.7147526399988;1576.9;553248.1369438606;715385.6987666611;643162.3387666617;600239.196840662
694.44;464.68;71528.9199999994;19.5;159.08031807999865;1337.7003180799989;1576.9;553786.32785713;716391.349989782;644862.4299897826;601878.9489903958
694.44;460.21;70834.4799999994;19.5;157.53588351999866;1331.6858835199987;1576.9;554319.2524412707;717398.4149039849;646563.9349039855;603520.0300097464
694.44;455.74;70140.0399999994;19.5;155.99144895999865;1325.6714489599988;1576.9;554846.903293157;718406.8954965617;648266.8554965623;605162.4417667686
694.44;451.28;69445.5999999994;19.5;154.44701439999864;1319.6670143999986;1576.9;555369.2830133135;719416.7937575978;649971.1937575984;606806.1861321426
694.44;446.81;68751.15999999939;19.5;152.90257983999865;1313.6525798399987;1576.9;555886.3741778058;720428.1116799763;651676.9516799769;608451.2649791783
694.44;442.34;68056.71999999939;19.5;151.35814527999864;1307.6381452799985;1576.9;556398.1693522632;721440.8512593819;653384.1312593825;610097.6801838196
694.44;437.87;67362.27999999939;19.5;149.81371071999862;1301.6237107199986;1576.9;556904.661091864;722455.0144943042;655092.7344943048;611745.4336246465
694.44;433.4;66667.83999999939;19.5;148.2692761599986;1295.6092761599987;1576.9;557405.8419413212;723470.6033860428;656802.7633860434;613394.5271828808
694.44;428.94;65973.39999999938;19.5;146.72484159999863;1289.6048415999987;1576.9;557734.3439345903;724487.6199387101;658514.2199387108;615044.9627423882
694.44;424.47;65278.95999999938;19.5;145.1804070399986;1283.5904070399988;1608.44;558193.0710062607;725506.0661592361;660227.1061592367;616696.7421896826
694.44;420.0;64584.51999999938;19.5;143.6359724799986;1277.5759724799987;1608.44;558646.4200427539;726525.944057372;661941.4240573726;618349.8674139302
694.44;415.53;63890.079999999376;19.5;142.09153791999861;1271.5615379199987;1608.44;559094.3834839138;727547.2556456942;663657.1756456948;620004.3403069532
694.44;411.06;63195.639999999374;19.5;140.5471033599986;1265.5471033599986;1608.44;559536.9537589565;728570.0029396082;665374.3629396087;621660.1627632322
694.44;406.59;62501.19999999937;19.5;139.0026687999986;1259.5326687999986;1608.44;559974.1232864555;729594.1879573525;667092.9879573531;623317.3366799119
694.44;402.13;61806.75999999937;19.5;137.45823423999857;1253.5282342399987;1608.44;560405.894488384;730619.8127200031;668813.0527200038;624975.8639568036
694.44;397.66;61112.31999999937;19.5;135.9137996799986;1247.5137996799988;1608.44;560832.2497620054;731646.8792514768;670534.5592514775;626635.7464963889
694.44;393.19;60417.879999999364;19.5;134.36936511999858;1241.4993651199986;1608.44;561253.1814938951;732675.3895785358;672257.5095785365;628296.9862038244
694.44;388.72;59723.43999999936;19.5;132.82493055999856;1235.4849305599987;1608.44;561668.6820599263;733705.3457307912;673981.9057307919;629959.5849869443
694.44;384.25;59028.99999999936;19.5;131.28049599999858;1229.4704959999985;1608.44;562078.7438252544;734736.7497407072;675707.7497407079;631623.5447562655
694.44;379.79;58334.55999999936;19.5;129.73606143999856;1223.4660614399986;1608.44;562483.3691583597;735769.6036436053;677435.0436436059;633288.8674249896
694.44;375.32;57640.119999999355;19.5;128.19162687999855;1217.4516268799985;1640.61;562681.4700825055;736803.9094776679;679163.7894776685;634955.5549090084
694.44;370.85;56945.67999999935;19.5;126.64719231999854;1211.4371923199985;1640.61;563042.6816946311;737839.6692839429;680893.9892839435;636623.609126907
694.44;366.38;56251.23999999935;19.5;125.10275775999855;1205.4227577599986;1640.61;563398.3781895255;738876.8851063472;682625.6451063477;638293.031999967
694.44;361.91;55556.79999999935;19.5;123.55832319999854;1199.4083231999987;1640.61;563748.5518143295;739915.5589916708;684358.7589916715;639963.8254521713
694.44;357.45;54862.359999999346;19.5;122.01388863999853;1193.4038886399985;1640.61;564093.2048193433;740955.6929895813;686093.3329895819;641635.991410207
694.44;352.98;54167.91999999934;19.5;120.46945407999853;1187.3894540799986;1640.61;564432.3194299153;741997.2891526272;687829.3691526279;643309.5318034702
694.44;348.51;53473.47999999934;19.5;118.92501951999853;1181.3750195199987;1640.61;564765.8878604646;743040.3495362429;689566.8695362436;644984.448564069
694.44;344.04;52779.03999999934;19.5;117.38058495999852;1175.3605849599985;1640.61;565093.9023144661;744084.8761987517;691305.8361987524;646660.7436268273
694.44;339.57;52084.59999999934;19.5;115.83615039999852;1169.3461503999986;1640.61;565416.3549844343;745130.8712013707;693046.2712013714;648338.4189292892
694.44;335.11;51390.159999999334;19.5;114.29171583999852;1163.3417158399986;1640.61;565733.2480659662;746178.3366082144;694788.1766082151;650017.4764117223
694.44;330.64;50695.71999999933;19.5;112.7472812799985;1157.3272812799985;1640.61;566044.56372963;747227.274486299;696531.5544862996;651697.9180171217
694.44;326.17;50001.27999999933;19.5;111.2028467199985;1151.3128467199986;1673.42;566317.4380124323;748277.6869055463;698276.406905547;653379.7456912142
694.44;321.7;49306.83999999933;19.5;109.6584121599985;1145.2984121599986;1673.42;566414.6975961777;749329.5759387881;700022.7359387889;655062.9613824616
694.44;317.23;48612.399999999325;19.5;108.11397759999849;1139.2839775999985;1673.42;566676.0464148475;750382.9436617699;701770.5436617705;656747.5670420644
694.44;312.77;47917.95999999932;19.5;106.56954303999849;1133.2795430399985;1673.42;566931.7497485318;751437.792153155;703519.8321531557;658433.5646239663
694.44;308.3;47223.51999999932;19.5;105.02510847999848;1127.2651084799984;1673.42;567181.7896470502;752494.1234945292;705270.6034945298;660120.956084858
694.44;303.83;46529.07999999932;19.5;103.48067391999848;1121.2506739199985;1673.42;567426.1581490462;753551.9397704041;707022.8597704049;661809.7433841806
694.44;299.36;45834.639999999315;19.5;101.93623935999847;1115.2362393599985;1673.42;567664.8472819721;754611.243068222;708776.6030682226;663499.9284841294
694.44;294.89;45140.19999999931;19.5;100.39180479999847;1109.2218047999986;1673.42;567897.8490620721;755672.0354783591;710531.8354783598;665191.5133496583
694.44;290.42;44445.75999999931;19.5;98.84737023999845;1103.2073702399987;1673.42;568125.1554943677;756734.3190941305;712288.5590941312;666884.4999484834
694.44;285.96;43751.31999999931;19.5;97.30293567999846;1097.2029356799985;1673.42;568346.768586699;757798.096011794;714046.7760117948;668578.8902510871
694.44;281.49;43056.879999999306;19.5;95.75850111999846;1091.1885011199986;1673.42;568562.6703216137;758863.3683305541;715806.4883305548;670274.6862307215
694.44;277.02;42362.439999999304;19.5;94.21406655999844;1085.1740665599984;1706.89;568739.33562004;759930.1381525662;717567.6981525668;671971.8898634128
694.44;272.55;41667.9999999993;19.5;92.66963199999844;1079.1596319999985;1706.89;568910.2263758279;760998.4075829407;719330.4075829413;673670.5031279649
694.44;268.08;40973.5599999993;19.5;109.07161671999813;1091.091616719998;1706.89;568922.5781269995;762068.1787297475;721094.6187297483;675370.5280059634
694.44;263.62;40279.1199999993;19.5;107.22301743999813;1084.7830174399983;1706.89;569099.3577658689;763139.4537040199;722860.3337040206;677071.9664817794
694.44;259.15;39584.679999999295;19.5;105.37441815999811;1078.464418159998;1706.89;569270.058430535;764212.2346197586;724627.5546197593;678774.8205425738
694.44;254.68;38890.23999999929;19.5;103.52581887999811;1072.1458188799982;1706.89;569434.6715754988;765286.5235939361;726396.2835939368;680479.0921783006
694.44;250.21;38195.79999999929;19.5;101.67721959999811;1065.8272195999982;1706.89;569593.1886432482;766362.322746501;728166.5227465017;682184.7833817117
694.44;245.74;37501.35999999929;19.5;99.8286203199981;1059.508620319998;1706.89;569745.6010642417;767439.6342003817;729938.2742003824;683891.8961483595
694.44;241.28;36806.919999999285;19.5;97.98002103999809;1053.200021039998;1706.89;569891.9102709487;768518.4600814912;731711.5400814919;685600.4324766025
694.44;236.81;36112.47999999928;19.5;96.13142175999809;1046.8814217599981;1706.89;570032.097669737;769598.8025187308;733486.3225187315;687310.3943676077
694.44;232.34;35418.03999999928;19.5;94.28282247999807;1040.5628224799982;1706.89;570166.1546548943;770680.6636439945;735262.6236439953;689021.7838253556
694.44;227.87;34723.59999999928;19.5;92.43422319999807;1034.244223199998;1741.02;570259.8946304691;771764.0455921735;737040.4455921742;690734.6028566437
694.44;223.4;34029.159999999276;19.5;90.58562391999807;1027.925623919998;1741.02;570347.4388990921;772848.9505011596;738819.7905011603;692448.8534710908
694.44;218.94;33334.71999999927;19.5;88.73702463999807;1021.6170246399981;1741.02;570428.7887652247;773935.3805118506;740600.6605118513;694164.5376811402
694.44;214.47;32640.279999999275;19.5;86.88842535999807;1015.2984253599982;1741.02;570332.7743293955;775023.3377681532;742383.0577681538;695881.6575020647
694.44;210.0;31945.839999999276;19.5;85.03982607999806;1008.9798260799981;1741.02;570401.4486175923;776112.8244169882;744166.9844169889;697600.2149519697
694.44;205.53;31251.399999999277;19.5;83.19122679999808;1002.6612267999981;1741.02;570463.8919628251;777203.8426082944;745952.4426082951;699320.2120517974
694.44;201.06;30556.95999999928;19.5;81.34262751999808;996.3426275199981;1741.02;570520.095605965;778296.394495033;747739.4344950337;701041.6508253317
694.44;196.6;29862.51999999928;19.5;79.49402823999807;990.0340282399982;1741.02;570570.0607896278;779390.4822331914;749527.962233192;702764.5332992006
694.44;192.13;29168.07999999928;19.5;77.64542895999809;983.7154289599981;1741.02;570613.7687300611;780486.107981788;751318.0279817887;704488.8615028815
694.44;187.66;28473.639999999283;19.5;75.79682967999808;977.3968296799981;1741.02;570651.2106311645;781583.2739028763;753109.633902877;706214.6374687044
694.44;183.19;27779.199999999284;19.5;73.9482303999981;971.0782303999982;1741.02;570682.3776844726;782681.9821615489;754902.7821615497;707941.8632318567
694.44;178.72;27084.759999999285;19.5;72.0996311199981;964.7596311199982;1775.84;570672.3921210311;783782.2349259421;756697.4749259428;709670.5408303863
694.44;174.25;26390.319999999287;19.5;70.25103183999809;958.4410318399981;1775.84;570656.0650387834;784884.0343672402;758493.7143672409;711400.6723052065
694.44;169.79;25695.879999999288;19.5;68.4024325599981;952.1324325599982;1775.84;570633.3975372168;785987.3826596792;760291.5026596799;713132.2597000991
694.44;165.32;25001.43999999929;19.5;66.5538332799981;945.8138332799981;1775.84;570604.370689249;787092.2819805518;762090.8419805525;714865.3050617194
694.44;160.85;24306.99999999929;19.5;64.70523399999811;939.4952339999982;1775.84;570397.8048625819;788198.7345102115;763891.7345102122;716599.8104395996
694.44;156.38;23612.559999999292;19.5;62.85663471999811;933.1766347199982;1775.84;570355.7918676811;789306.7424320767;765694.1824320775;718335.7778861528
694.44;151.91;22918.119999999293;19.5;61.008035439998125;926.8580354399982;1775.84;570307.392331512;790416.3079326352;767498.1879326359;720073.2094566778
694.44;147.45;22223.679999999295;19.5;59.15943615999812;920.5494361599982;1775.84;570252.6072902714;791527.4332014483;769303.753201449;721812.1072093622
694.44;142.98;21529.239999999296;19.5;57.31083687999812;914.2308368799982;1775.84;570191.4177534981;792640.1204311554;771110.8804311561;723552.4732052868
694.44;138.51;20834.799999999297;19.5;55.46223759999812;907.9122375999982;1775.84;570123.8147180923;793754.3718174782;772919.5718174789;725294.3095084302
694.44;134.04;20140.3599999993;19.5;53.61363831999813;901.5936383199981;1775.84;570049.7891682982;794870.189559225;774729.8295592257;727037.6181856722
694.44;129.57;19445.9199999993;19.5;51.765039039998136;895.2750390399981;1811.36;569933.7621435567;795987.5758582951;776541.6558582957;728782.401306798
694.44;125.11;18751.4799999993;19.5;49.916439759998134;888.9664397599983;1811.36;569811.2545466118;797106.532919683;778355.0529196837;730528.6609445028
694.44;120.64;18057.039999999302;19.5;48.06784047999814;882.6478404799982;1811.36;569682.2472533619;798227.0629514831;780170.0229514837;732276.3991743948
694.44;116.17;17362.599999999304;19.5;46.219241199998145;876.3292411999981;1811.36;569546.731126879;799349.1681648935;781986.5681648942;734025.6180750006
694.44;111.7;16668.159999999305;19.5;44.37064191999815;870.0106419199983;1811.36;569404.6970173911;800472.850774221;783804.6907742217;735776.3197277684
694.44;107.23;15973.719999999304;19.5;42.52204263999815;863.6920426399982;1811.36;569085.3589215352;801598.112996885;785624.3929968857;737528.5062170726
694.44;102.77;15279.279999999304;19.5;40.673443359998146;857.3834433599982;1811.36;568930.0312902981;802724.9570534219;787445.6770534226;739282.1796302173
694.44;98.3;14584.839999999303;19.5;38.824844079998144;851.0648440799981;1811.36;568768.1578260948;803853.3851674898;789268.5451674905;741037.3420574411
694.44;93.83;13890.399999999303;19.5;36.97624479999814;844.7462447999983;1811.36;568599.7293271407;804983.3995658726;791092.9995658733;742793.9955919209
694.44;89.36;13195.959999999302;19.5;35.12764551999814;838.4276455199982;1811.36;568424.7365787164;806115.0024784848;792919.0424784855;744552.1423297764
694.44;84.89;12501.519999999302;19.5;33.27904623999814;832.1090462399982;1811.36;568243.1703531485;807248.1961383751;794746.6761383758;746311.7843700732
694.44;80.43;11807.079999999301;19.5;31.43044695999814;825.8004469599982;1847.59;568018.7504936393;808382.9827817316;796575.9027817324;748072.9238148285
694.44;75.96;11112.639999999301;19.5;29.581847679998138;819.4818476799983;1847.59;567787.6876749786;809519.3646478859;798406.7246478866;749835.5627690135
694.44;71.49;10418.1999999993;19.5;27.73324839999814;813.1632483999982;1847.59;567549.9725588474;810657.3439793175;800239.1439793182;751599.7033405592
694.44;67.02;9723.7599999993;19.5;25.884649119998134;806.8446491199982;1847.59;567305.595793799;811796.9230216581;802073.1630216588;753365.3476403593
694.44;62.55;9029.3199999993;19.5;24.036049839998135;800.5260498399981;1847.59;567054.5480152412;812938.1040236965;803908.7840236973;755132.4977822754
694.44;58.08;8334.879999999299;19.5;22.187450559998133;794.2074505599983;1847.59;566796.8198454174;814080.8892373826;805746.0092373833;756901.1558831403
694.44;53.62;7640.439999999298;19.5;20.33885127999813;787.8988512799982;1847.59;566362.4521838737;815225.2809178318;807584.8409178326;758671.3240627627
694.44;49.15;6945.999999999298;19.5;18.49025199999813;781.5802519999982;1847.59;566091.1061532805;816371.2813233298;809425.2813233305;760443.0044439307
694.44;44.68;6251.559999999297;19.5;16.641652719998127;775.2616527199981;1847.59;565813.0511972165;817518.8927153369;811267.3327153376;762216.1991524175
694.44;40.21;5557.119999999297;19.5;14.793053439998127;768.9430534399983;1847.59;565528.2778846307;818668.1173584923;813110.997358493;763990.9103169835
694.44;35.74;4862.679999999296;19.5;12.944454159998127;762.6244541599982;1847.59;565236.7767712144;819818.9575206189;814956.2775206196;765767.1400693824
694.44;31.28;4168.239999999296;19.5;11.095854879998125;756.3158548799981;1884.54;564901.5464710922;820971.4154727274;816803.1754727281;767544.8905443645
694.44;26.81;3473.799999999296;19.5;9.247255599998125;749.9972555999981;1884.54;564559.5174403859;822125.493489021;818651.6934890216;769324.1638796803
694.44;22.34;2779.3599999992957;19.5;7.398656319998125;743.6786563199983;1884.54;564210.6801218012;823281.1938468999;820501.8338469006;771104.9622160866
694.44;17.87;2084.9199999992957;19.5;5.550057039998125;737.3600570399982;1884.54;563855.0249446084;824438.5188269658;822353.5988269665;772887.2876973485
694.44;13.4;1390.4799999992956;19.5;3.7014577599981253;731.0414577599981;1884.54;563492.5423246243;825597.4707130262;824206.990713027;774671.1424702454
694.44;8.94;696.0399999992956;19.5;1.8528584799981247;724.7328584799982;1884.54;563123.2326782496;826758.0517920993;826062.0117920999;776456.528684574
694.44;4.47;1.5999999992955054;19.5;0.004259199998124635;718.4142591999982;1884.54;562747.0763943556;827920.2643544179;827918.6643544186;778243.4484931536
694.44;0.0;-692.8400000007045;19.5;-2.2829078000023215;711.6570921999977;;;;;
