amortization;interest;balance;dfi;mip;payment;rent;rent_savings;home_value;equity;purchase_savings
694.44;1608.51;249305.56;214.5;79.27916808;2596.72916808;1000.0;250000.0;3000000.0;2750694.44;2570694.44
694.44;1604.04;248611.12;214.5;79.05833616000001;2592.03833616;1000.0;251945.7130622783;3004217.24067809;2755606.12067809;2575353.0862374045
694.44;1599.57;247916.68;214.5;78.83750424;2587.34750424;1000.0;253889.46387860554;3008440.409729159;2760523.729729159;2580017.3051454094
694.44;1595.1;247222.24;214.5;78.61667232;2582.65667232;1000.0;255831.24969056065;3012669.515486999;2765447.275486999;2584687.104557779
694.44;1590.64;246527.8;214.5;78.3958404;2577.9758404;1000.0;257771.07774990227;3016904.5662971167;2770376.766297117;2589362.49231929
694.44;1586.17;245833.36;214.5;78.17500848;2573.28500848;1000.0;259708.93529046825;3021145.570516751;2775312.2105167513;2594043.4762857463
694.44;1581.7;245138.91999999998;214.5;77.95417656000001;2568.5941765600005;1000.0;261644.819542208;3025392.5365148894;2780253.6165148895;2598730.064323996
694.44;1577.23;244444.47999999998;214.5;77.73334464;2563.90334464;1000.0;263578.7277311768;3029645.472672283;2785200.992672283;2603422.264311946
694.44;1572.76;243750.03999999998;214.5;77.51251272;2559.2125127199997;1000.0;265510.6570795307;3033904.3873814647;2790154.3473814647;2608120.084138577
694.44;1568.29;243055.59999999998;214.5;77.2916808;2554.5216808;1000.0;267440.60480552056;3038169.289046765;2795113.6890467647;2612823.5317039588
694.44;1563.83;242361.15999999997;214.5;77.07084888;2549.84084888;1000.0;269368.57813754433;3042440.1860843287;2800079.0260843285;2617532.614919269
694.44;1559.36;241666.71999999997;214.5;76.85001696;2545.1500169600004;1000.0;271294.56428604637;3046717.0869221324;2805050.3669221327;2622247.341706805
694.44;1554.89;240972.27999999997;214.5;76.62918504;2540.4591850399997;1020.0;273116.57278290903;3050999.999999999;2810027.7199999993;2626967.7199999993
694.44;1550.42;240277.83999999997;214.5;76.40835312;2535.76835312;1020.0;275018.40469621506;3055288.9337696168;2815011.093769617;2631693.75774344
694.44;1545.95;239583.39999999997;214.5;76.18752119999999;2531.0775212000003;1020.0;276918.21267778124;3059583.896694554;2820000.496694554;2636425.4628928807
694.44;1541.49;238888.95999999996;214.5;75.96668928;2526.3966892800004;1020.0;278816.00389652926;3063884.897250277;2824995.937250277;2641162.8434152603
694.44;1537.02;238194.51999999996;214.5;75.74585735999999;2521.70585736;1020.0;280711.7655033436;3068191.9439241667;2829997.4239241667;2645905.9072887166
694.44;1532.55;237500.07999999996;214.5;75.52502544;2517.0150254399996;1020.0;282605.4946451037;3072505.045215535;2835004.965215535;2650654.6625026027
694.44;1528.08;236805.63999999996;214.5;75.30419352;2512.32419352;1020.0;284497.188464678;3076824.2096356414;2840018.5696356413;2655409.1170575027
694.44;1523.61;236111.19999999995;214.5;75.08336159999999;2507.6333616;1020.0;286386.8441009187;3081149.4457077105;2845038.2457077103;2660169.278965248
694.44;1519.15;235416.75999999995;214.5;74.86252968;2502.95252968;1020.0;288274.4687027134;3085480.7619669484;2850064.0019669486;2664935.156248932
694.44;1514.68;234722.31999999995;214.5;74.64169775999999;2498.26169776;1020.0;290160.04940088425;3089818.166960559;2855095.846960559;2669706.7569429255
694.44;1510.21;234027.87999999995;214.5;74.42086583999999;2493.57086584;1020.0;292043.5833222201;3094161.6692477614;2860133.7892477615;2674484.089092896
694.44;1505.74;233333.43999999994;214.5;74.20003392;2488.88003392;1040.4;293904.6389122341;3098511.2773998077;2865177.8373998078;2679267.160755819
694.44;1501.27;232638.99999999994;214.5;73.97920199999999;2484.189202;1040.4;295674.88416534377;3102866.999999998;2870227.999999998;2684055.979999998
694.44;1496.81;231944.55999999994;214.5;73.75837007999999;2479.50837008;1040.4;297531.65960720717;3107228.845643699;2875284.285643699;2688850.554905077
694.44;1492.34;231250.11999999994;214.5;73.53753815999998;2474.81753816;1040.4;299386.347779336;3111596.8229383603;2880346.70293836;2693650.8935620585
694.44;1487.87;230555.67999999993;214.5;73.31670623999999;2470.1267062399997;1040.4;301238.94574755727;3115970.9405035307;2885415.2605035305;2698457.0040733186
694.44;1483.4;229861.23999999993;214.5;73.09587431999998;2465.43587432;1040.4;303089.4505735735;3120351.2069708765;2890489.966970877;2703268.8945526243
694.44;1478.93;229166.79999999993;214.5;72.87504239999998;2460.7450424;1040.4;304937.85931495635;3124737.6309841983;2895570.8309841985;2708086.573125147
694.44;1474.47;228472.35999999993;214.5;72.65421047999999;2456.06421048;1040.4;306784.1790391989;3129130.221199447;2900657.861199447;2712910.04792748
694.44;1470.0;227777.91999999993;214.5;72.43337855999998;2451.37337856;1040.4;308628.39679561433;3133528.986284741;2905751.0662847413;2717739.3271076567
694.44;1465.53;227083.47999999992;214.5;72.21254663999999;2446.68254664;1040.4;310470.50962936797;3137933.934920386;2910850.454920386;2722574.4188251626
694.44;1461.06;226389.03999999992;214.5;71.99171471999998;2441.99171472;1040.4;312310.5145814712;3142345.0757988878;2915956.0357988877;2727415.3312509544
694.44;1456.59;225694.59999999992;214.5;71.77088279999998;2437.3008827999997;1061.21;314127.5694351832;3146762.4176249728;2921067.8176249727;2732262.072567474
694.44;1452.12;225000.15999999992;214.5;71.55005087999999;2432.61005088;1061.21;315942.4811820672;3151185.9691156037;2926185.8091156036;2737114.650968667
694.44;1447.66;224305.7199999999;214.5;71.32921895999998;2427.9292189600005;1061.21;317659.93024646793;3155615.7389999973;2931310.0189999975;2741973.0746599976
694.44;1443.19;223611.2799999999;214.5;71.10838703999998;2423.23838704;1061.21;319470.422760559;3160051.736019641;2936440.4560196414;2746837.351858463
694.44;1438.72;222916.8399999999;214.5;70.88755511999997;2418.5475551199997;1061.21;321278.7629428336;3164493.9689283115;2941577.1289283116;2751707.490792613
694.44;1434.25;222222.3999999999;214.5;70.66672319999998;2413.8567232;1061.21;323084.9477676579;3168942.44649209;2946720.04649209;2756583.4997025644
694.44;1429.78;221527.9599999999;214.5;70.44589127999998;2409.1658912800003;1061.21;324888.9742051451;3173397.177489381;2951869.217489381;2761465.386840018
694.44;1425.32;220833.5199999999;214.5;70.22505935999997;2404.4850593600004;1061.21;326690.84923520614;3177858.1707109287;2957024.6507109287;2766353.160468273
694.44;1420.85;220139.0799999999;214.5;70.00422743999998;2399.7942274399998;1061.21;328490.5598194493;3182325.4349598363;2962186.354959836;2771246.828862246
694.44;1416.38;219444.6399999999;214.5;69.78339551999997;2395.10339552;1061.21;330288.10291521164;3186798.9790515807;2967354.339051581;2776146.400308486
694.44;1411.91;218750.1999999999;214.5;69.56256359999998;2390.4125636000003;1061.21;332083.4754755529;3191278.8118140316;2972528.611814032;2781051.88310519
694.44;1407.44;218055.7599999999;214.5;69.34173167999997;2385.72173168;1082.43;333855.42461930064;3195764.9420874678;2977709.182087468;2785963.28556222
694.44;1402.98;217361.3199999999;214.5;69.12089975999997;2381.0408997600002;1082.43;335625.1772630663;3200257.378724596;2982896.058724596;2790880.6160011203
694.44;1398.51;216666.8799999999;214.5;68.90006783999998;2376.3500678399996;1082.43;337392.7203050694;3204756.130590568;2988089.250590568;2795803.882755134
694.44;1394.04;215972.4399999999;214.5;68.67923591999997;2371.65923592;1082.43;339056.30322397733;3209261.2065629964;2993288.7665629964;2800733.0941692167
694.44;1389.57;215277.99999999988;214.5;68.45840399999997;2366.968404;1082.43;340819.2747085536;3213772.6155319745;2998494.6155319745;2805668.258600056
694.44;1385.1;214583.55999999988;214.5;68.23757207999996;2362.27757208;1082.43;342580.02705877385;3218290.3664000924;3003706.8064000923;2810609.3844160866
694.44;1380.64;213889.11999999988;214.5;68.01674015999997;2357.59674016;1082.43;344338.56716915435;3222814.468082455;3008925.348082455;2815556.4799975078
694.44;1376.17;213194.67999999988;214.5;67.79590823999997;2352.90590824;1082.43;346094.8819157883;3227344.9295067;3014150.2495067003;2820509.5537362983
694.44;1371.7;212500.23999999987;214.5;67.57507631999997;2348.21507632;1082.43;347848.9681703775;3231881.7596130143;3019381.5196130145;2825468.6140362336
694.44;1367.23;211805.79999999987;214.5;67.35424439999997;2343.5242444;1082.43;349600.82280022616;3236424.9673541533;3024619.1673541535;2830433.669312904
694.44;1362.76;211111.35999999987;214.5;67.13341247999996;2338.83341248;1082.43;351350.4426682349;3240974.5616954574;3029863.2016954576;2835404.72799373
694.44;1358.3;210416.91999999987;214.5;66.91258055999997;2334.15258056;1104.08;353076.1542125312;3245530.55161487;3035113.63161487;2840381.798517978
694.44;1353.83;209722.47999999986;214.5;66.69174863999996;2329.4617486399998;1104.08;354799.5942444263;3250092.9461029544;3040370.4661029545;2845364.8893367774
694.44;1349.36;209028.03999999986;214.5;66.47091671999996;2324.77091672;1104.08;356520.7595707486;3254661.754162914;3045633.714162914;2850354.0089131393
694.44;1344.89;208333.59999999986;214.5;66.25008479999997;2320.0800848;1104.08;358239.6469938378;3259236.9848106075;3050903.384810608;2855349.1657219715
694.44;1340.42;207639.15999999986;214.5;91.15359123999994;2340.51359124;1104.08;359873.4185444686;3263818.647074567;3056179.4870745675;2860350.3682500934
694.44;1335.95;206944.71999999986;214.5;90.84873207999993;2335.7387320800003;1104.08;361612.6996168671;3268406.7499960177;3061462.029996018;2865357.624996257
694.44;1331.49;206250.27999999985;214.5;90.54387291999993;2330.9738729200003;1104.08;363349.65412088274;3273001.3026288934;3066751.0226288936;2870370.94447116
694.44;1327.02;205555.83999999985;214.5;90.23901375999993;2326.19901376;1104.08;365084.2687718917;3277602.314039856;3072046.4740398563;2875390.335197465
694.44;1322.55;204861.39999999985;214.5;89.93415459999993;2321.4241546;1104.08;366816.54028065293;3282209.793308313;3077348.393308313;2880415.805709814
694.44;1318.08;204166.95999999985;214.5;89.62929543999994;2316.64929544;1104.08;368546.46535330144;3286823.7495264346;3082656.7895264346;2885447.3645548485
694.44;1313.61;203472.51999999984;214.5;89.32443627999993;2311.8744362800003;1104.08;370274.040691342;3291444.191799173;3087971.671799173;2890485.0202912227
694.44;1309.15;202778.07999999984;214.5;89.01957711999992;2307.1095771200003;1126.16;371977.16196680855;3296071.1292442796;3093293.04924428;2895528.7814896232
694.44;1304.68;202083.63999999984;214.5;88.71471795999993;2302.33471796;1126.16;373677.89582831255;3300704.570992322;3098620.9309923225;2900578.656732783
694.44;1300.21;201389.19999999984;214.5;88.40985879999992;2297.5598588;1126.16;375376.2389197542;3305344.526186704;3103955.3261867044;2905634.6546155023
694.44;1295.74;200694.75999999983;214.5;88.10499963999993;2292.78499964;1126.16;377072.187880316;3309991.003983683;3109296.243983683;2910696.783744662
694.44;1291.27;200000.31999999983;214.5;87.80014047999992;2288.01014048;1126.16;378765.7393444558;3314644.013552387;3114643.693552387;2915765.052739244
694.44;1286.81;199305.87999999983;214.5;87.49528131999992;2283.24528132;1126.16;380342.7628859712;3319303.564074834;3119997.684074834;2920839.4702303438
694.44;1282.34;198611.43999999983;214.5;87.19042215999993;2278.4704221599995;1126.16;382031.35882201325;3323969.664745949;3125358.2247459493;2925920.0448611923
694.44;1277.87;197916.99999999983;214.5;86.88556299999992;2273.6955629999998;1126.16;383717.54692514194;3328642.324773584;3130725.324773584;2931006.785287169
694.44;1273.4;197222.55999999982;214.5;86.58070383999993;2268.92070384;1126.16;385401.3238105537;3333321.553378533;3136098.993378533;2936099.700175821
694.44;1268.93;196528.11999999982;214.5;86.27584467999992;2264.1458446799998;1126.16;387082.68608868663;3338007.359794554;3141479.239794554;2941198.798206881
694.44;1264.47;195833.67999999982;214.5;85.97098551999991;2259.3809855199997;1126.16;388761.6403792716;3342699.753268384;3146866.073268384;2946304.0880722813
694.44;1260.0;195139.23999999982;214.5;85.66612635999992;2254.60612636;1148.69;390415.61161175265;3347398.743059759;3152259.5030597593;2951415.578476174
694.44;1255.53;194444.7999999998;214.5;85.36126719999992;2249.8312672;1148.69;392067.12633775093;3352104.338441432;3157659.538441432;2956533.2781349462
694.44;1251.06;193750.3599999998;214.5;85.05640803999991;2245.05640804;1148.69;393716.18110404006;3356816.5486991913;3163066.1886991914;2961657.19577724
694.44;1246.59;193055.9199999998;214.5;84.75154887999992;2240.2815488799997;1148.69;395362.77245253936;3361535.383131878;3168479.463131878;2966787.3401439656
694.44;1242.13;192361.4799999998;214.5;84.44668971999991;2235.51668972;1148.69;397006.9069343644;3366260.8510514055;3173899.3710514056;2971923.7199883214
694.44;1237.66;191667.0399999998;214.5;84.14183055999992;2230.7418305600004;1148.69;398648.57108172507;3370992.9617827777;3179325.9217827776;2977066.344075811
694.44;1233.19;190972.5999999998;214.5;83.83697139999991;2225.9669714;1148.69;400167.6750935297;3375731.724664106;3184759.1246641064;2982215.22118426
694.44;1228.72;190278.1599999998;214.5;83.5321122399999;2221.19211224;1148.69;401804.21933810174;3380477.14904663;3190198.9890466304;2987370.3601038326
694.44;1224.25;189583.7199999998;214.5;83.22725307999991;2216.41725308;1148.69;403438.28257825697;3385229.2442947347;3195645.524294735;2992531.769637051
694.44;1219.78;188889.2799999998;214.5;82.9223939199999;2211.6423939200004;1148.69;405069.86132633104;3389988.019785968;3201098.7397859683;2997699.4585988102
694.44;1215.32;188194.8399999998;214.5;82.61753475999991;2206.8775347600003;1148.69;406698.96210381447;3394753.4849110614;3206558.6449110615;3002873.435816398
694.44;1210.85;187500.3999999998;214.5;82.3126755999999;2202.1026755999997;1171.66;408302.5691232442;3399525.6490739463;3212025.2490739464;3008053.7101295097
694.44;1206.38;186805.9599999998;214.5;82.0078164399999;2197.32781644;1171.66;409903.6488368552;3404304.5216917745;3217498.5616917745;3013240.290390268
694.44;1201.91;186111.5199999998;214.5;81.70295727999991;2192.55295728;1171.66;411502.19769189507;3409090.112194936;3222978.5921949362;3018433.18546324
694.44;1197.44;185417.07999999978;214.5;81.3980981199999;2187.77809812;1171.66;413098.21213061735;3413882.430027077;3228465.3500270774;3023632.404225453
694.44;1192.98;184722.63999999978;214.5;81.09323895999991;2183.01323896;1171.66;414691.6986043316;3418681.4846451194;3233958.8446451197;3028837.955566413
694.44;1188.51;184028.19999999978;214.5;80.7883797999999;2178.2383797999996;1171.66;416282.6435453014;3423487.285519279;3239459.0855192794;3034049.8483881224
694.44;1184.04;183333.75999999978;214.5;80.4835206399999;2173.46352064;1171.66;417871.043380775;3428299.8421330843;3244966.0821330845;3039268.0916050994
694.44;1179.57;182639.31999999977;214.5;80.1786614799999;2168.68866148;1171.66;419331.0574646184;3433119.1639833953;3250479.8439833955;3044492.694144392
694.44;1175.1;181944.87999999977;214.5;79.8738023199999;2163.91380232;1171.66;420914.1794556799;3437945.2605804224;3256000.3805804225;3049723.6649455973
694.44;1170.64;181250.43999999977;214.5;79.5689431599999;2159.14894316;1171.66;422494.75535821513;3442778.1414477443;3261527.7014477444;3054961.0129608796
694.44;1166.17;180555.99999999977;214.5;79.2640839999999;2154.374084;1171.66;424072.7715790105;3447617.8161223284;3267061.816122329;3060204.7471549893
694.44;1161.7;179861.55999999976;214.5;78.95922483999989;2149.5992248400003;1195.09;425624.7615831518;3452464.294154548;3272602.7341545485;3065454.8765052757
694.44;1157.23;179167.11999999976;214.5;78.6543656799999;2144.82436568;1195.09;427174.1517210156;3457317.585108202;3278150.4651082023;3070711.41000171
694.44;1152.76;178472.67999999976;214.5;78.34950651999989;2140.04950652;1195.09;428720.93833784777;3462177.6985605336;3283705.018560534;3075974.356646902
694.44;1148.3;177778.23999999976;214.5;78.04464735999989;2135.28464736;1195.09;430265.12778781424;3467044.644102249;3289266.404102249;3081243.725456114
694.44;1143.83;177083.79999999976;214.5;77.7397881999999;2130.5097882;1195.09;431806.7064058983;3471918.4313375363;3294834.6313375365;3086519.5254572844
694.44;1139.36;176389.35999999975;214.5;77.43492903999989;2125.73492904;1195.09;433345.6705219312;3476799.0698840856;3300409.7098840857;3091801.7656910405
694.44;1134.89;175694.91999999975;214.5;77.1300698799999;2120.96006988;1195.09;434882.0164605847;3481686.5693731057;3305991.6493731057;3097090.4552107193
694.44;1130.42;175000.47999999975;214.5;76.82521071999989;2116.18521072;1195.09;436415.74054136424;3486580.9394493457;3311580.459449346;3102385.6030823854
694.44;1125.96;174306.03999999975;214.5;76.52035155999988;2111.42035156;1195.09;437815.4650379308;3491482.189771112;3317176.1497711125;3107687.2183848456
694.44;1121.49;173611.59999999974;214.5;76.21549239999989;2106.6454924;1195.09;439343.7596761834;3496390.3300102884;3322778.730010289;3112995.3102096715
694.44;1117.02;172917.15999999974;214.5;75.91063323999988;2101.8706332399997;1195.09;440869.4211384714;3501305.369852355;3328388.2098523555;3118309.887661214
694.44;1112.55;172222.71999999974;214.5;75.60577407999989;2097.09577408;1218.99;442368.51212586515;3506227.3189964076;3334004.598996408;3123630.9598566233
694.44;1108.08;171528.27999999974;214.5;75.30091491999988;2092.3209149199997;1218.99;443864.9288843529;3511156.187155175;3339627.907155175;3128958.5359258647
694.44;1103.61;170833.83999999973;214.5;74.99605575999988;2087.54605576;1218.99;445358.66765464563;3516091.9840550413;3345258.1440550415;3134292.625011739
694.44;1099.15;170139.39999999973;214.5;74.69119659999988;2082.7811966;1218.99;446849.7346862272;3521034.7194360625;3350895.3194360626;3139633.2362698987
694.44;1094.68;169444.95999999973;214.5;74.38633743999988;2078.00633744;1218.99;448338.11620925186;3525984.403051987;3356539.4430519873;3144980.378868868
694.44;1090.21;168750.51999999973;214.5;74.08147827999989;2073.23147828;1218.99;449823.8084485742;3530941.044670274;3362190.5246702745;3150334.061990058
694.44;1085.74;168056.07999999973;214.5;73.77661911999988;2068.45661912;1218.99;451306.80762374203;3535904.6540721143;3367848.5740721147;3155694.2948277877
694.44;1081.27;167361.63999999972;214.5;73.47175995999987;2063.68175996;1218.99;452787.10994898883;3540875.241052448;3373513.601052448;3161061.0865893015
694.44;1076.81;166667.19999999972;214.5;73.16690079999988;2058.9169008;1218.99;454264.72164728364;3545852.815419984;3379185.6154199843;3166434.446494785
694.44;1072.34;165972.75999999972;214.5;118.3385778799998;2099.61857788;1218.99;455648.4338361519;3550837.3869972206;3384864.626997221;3171814.3837773874
694.44;1067.87;165278.31999999972;214.5;117.8434421599998;2094.65344216;1218.99;457165.8546095021;3555828.9656204632;3390550.6456204634;3177200.9076832356
694.44;1063.4;164583.8799999997;214.5;117.34830643999979;2089.68830644;1243.37;458656.02210483595;3560827.5611398453;3396243.6811398454;3182594.027471455
694.44;1058.93;163889.4399999997;214.5;116.85317071999981;2084.72317072;1243.37;460143.31228305184;3565833.1834193463;3401943.7434193464;3187993.7524141856
694.44;1054.47;163194.9999999997;214.5;116.35803499999979;2079.768035;1243.37;461627.73111342767;3570845.842336813;3407650.8423368135;3193400.091796605
694.44;1050.0;162500.5599999997;214.5;115.8628992799998;2074.80289928;1243.37;463109.2645455176;3575865.547783977;3413364.9877839773;3198813.0549169388
694.44;1045.53;161806.1199999997;214.5;115.36776355999979;2069.83776356;1243.37;464587.9085231821;3580892.3096664753;3419086.1896664756;3204232.6510864873
694.44;1041.06;161111.6799999997;214.5;114.87262783999978;2064.87262784;1243.37;466063.65898457944;3585926.1379038705;3424814.457903871;3209658.8896296388
694.44;1036.59;160417.2399999997;214.5;114.37749211999979;2059.90749212;1243.37;467536.5118621582;3590967.042429669;3430549.802429669;3215091.779883889
694.44;1032.13;159722.7999999997;214.5;113.88235639999976;2054.9523564;1243.37;469006.4730967063;3596015.0331913405;3436292.2331913407;3220531.33119986
694.44;1027.66;159028.3599999997;214.5;113.38722067999979;2049.98722068;1243.37;470473.5286092482;3601070.12015034;3442041.76015034;3225977.5529413195
694.44;1023.19;158333.9199999997;214.5;112.89208495999978;2045.0220849599998;1243.37;471937.6743150742;3606132.3132821238;3447798.393282124;3231430.4544851966
694.44;1018.72;157639.4799999997;214.5;112.39694923999977;2040.0569492399998;1243.37;473256.88645189535;3611201.6225761734;3453562.142576174;3236890.0452216035
694.44;1014.25;156945.0399999997;214.5;111.90181351999978;2035.0918135199997;1268.24;474690.09566254646;3616278.058036011;3459333.0180360116;3242356.334553851
694.44;1009.79;156250.5999999997;214.5;111.40667779999978;2030.1366777999997;1268.24;476120.35750120535;3621361.6296792226;3465111.029679223;3247829.3318984695
694.44;1005.32;155556.15999999968;214.5;110.91154207999978;2025.17154208;1268.24;477547.6578105556;3626452.347537475;3470896.1875374755;3253309.046685227
694.44;1000.85;154861.71999999968;214.5;110.41640635999977;2020.2064063599996;1268.24;478971.9924274365;3631550.2216565385;3476688.501656539;3258795.4883571463
694.44;996.38;154167.27999999968;214.5;109.92127063999976;2015.24127064;1268.24;480393.35718283517;3636655.262096304;3482487.982096304;3264288.666370526
694.44;991.91;153472.83999999968;214.5;109.42613491999977;2010.2761349199998;1268.24;481811.747901878;3641767.478930805;3488294.638930805;3269788.590194957
694.44;987.44;152778.39999999967;214.5;108.93099919999976;2005.3109992;1268.24;483227.16040382267;3646886.882248236;3494108.4822482364;3275295.2693133424
694.44;982.98;152083.95999999967;214.5;108.43586347999977;2000.35586348;1268.24;484639.60051610717;3652013.482150973;3499929.5221509733;3280808.713221915
694.44;978.51;151389.51999999967;214.5;107.94072775999976;1995.39072776;1268.24;486049.0540462465;3657147.288755593;3505757.7687555933;3286328.931430258
694.44;974.04;150695.07999999967;214.5;107.44559203999977;1990.4255920399999;1268.24;487455.5167958622;3662288.312192895;3511593.2321928954;3291855.9334613215
694.44;969.57;150000.63999999966;214.5;106.95045631999974;1985.46045632;1268.24;488858.98456067365;3667436.5626079193;3517435.9226079197;3297389.7288514446
694.44;965.1;149306.19999999966;214.5;106.45532059999975;1980.4953205999998;1293.61;490086.97725245176;3672592.0501599675;3523285.850159968;3302930.3271503695
694.44;960.64;148611.75999999966;214.5;105.96018487999976;1975.5401848799997;1293.61;491458.80430399394;3677754.7850226224;3529143.0250226227;3308477.7379212654
694.44;956.17;147917.31999999966;214.5;105.46504915999975;1970.57504916;1293.61;492827.58768170705;3682924.7773837685;3535007.4573837686;3314031.9707407425
694.44;951.7;147222.87999999966;214.5;104.96991343999976;1965.60991344;1293.61;494193.323106956;3688102.0374456113;3540879.1574456114;3319593.035198875
694.44;947.23;146528.43999999965;214.5;104.47477771999975;1960.6447777199999;1293.61;495556.0062950912;3693286.5754246986;3546758.135424699;3325160.9408992175
694.44;942.76;145833.99999999965;214.5;103.97964199999974;1955.6796419999998;1293.61;496915.6329554397;3698478.4015519405;3552644.401551941;3330735.6974588246
694.44;938.3;145139.55999999965;214.5;103.48450627999975;1950.7245062799998;1293.61;498272.20880535454;3703677.526072628;3558537.9660726283;3336317.3145082705
694.44;933.83;144445.11999999965;214.5;102.98937055999974;1945.7593705599998;1293.61;499625.71954211104;3708883.9592464548;3564438.839246455;3341905.8016916676
694.44;929.36;143750.67999999964;214.5;102.49423483999975;1940.79423484;1293.61;500976.16085693584;3714097.711347538;3570347.0313475383;3347501.168666686
694.44;924.89;143056.23999999964;214.5;101.99909911999974;1935.8290991199997;1293.61;502323.5284349986;3719318.7926644366;3576262.552664437;3353103.4251045706
694.44;920.42;142361.79999999964;214.5;101.50396339999973;1930.8639633999999;1293.61;503667.8179554035;3724547.213500173;3582185.413500173;3358712.5806901627
694.44;915.96;141667.35999999964;214.5;101.00882767999974;1925.9088276799998;1319.48;504983.1287385658;3729782.984172253;3588115.6241722535;3364328.6451219185
694.44;911.49;140972.91999999963;214.5;100.51369195999973;1920.9436919599998;1319.48;506143.42780541023;3735026.1150126862;3594053.195012687;3369951.6281119254
694.44;907.02;140278.47999999963;214.5;100.01855623999974;1915.9785562399998;1319.48;507452.2744385385;3740276.6163680064;3599998.136368007;3375581.5393859264
694.44;902.55;139584.03999999963;214.5;99.52342051999973;1911.0134205199997;1319.48;508757.98886331014;3745534.498599292;3605950.458599292;3381218.388683335
694.44;898.08;138889.59999999963;214.5;99.02828479999974;1906.0482847999997;1319.48;510060.566676633;3750799.772082186;3611910.172082186;3386862.185757255
694.44;893.62;138195.15999999963;214.5;98.53314907999973;1901.0931490799996;1319.48;511360.0134832829;3756072.4472069177;3617877.287206918;3392512.940374503
694.44;889.15;137500.71999999962;214.5;98.03801335999972;1896.1280133599998;1319.48;512656.3148677993;3761352.5343783223;3623851.8143783226;3398170.6623156234
694.44;884.68;136806.27999999962;214.5;97.54287763999973;1891.1628776399996;1319.48;513949.4664085149;3766640.0440158616;3629833.764015862;3403835.36137491
694.44;880.21;136111.83999999962;214.5;97.04774191999972;1886.1977419199998;1319.48;515239.4636775465;3771934.986553644;3635823.146553644;3409507.0473604253
694.44;875.74;135417.39999999962;214.5;96.55260619999973;1881.2326061999997;1319.48;516526.3022407865;3777237.3724404457;3641819.9724404463;3415185.7300940193
694.44;871.27;134722.9599999996;214.5;96.05747047999972;1876.2674704799997;1319.48;517809.97765789414;3782547.2121397317;3647824.2521397322;3420871.419411348
694.44;866.81;134028.5199999996;214.5;95.56233475999971;1871.3123347599997;1345.87;519064.06839868345;3787864.516129676;3653835.9961296762;3426564.1251618955
694.44;862.34;133334.0799999996;214.5;95.06719903999972;1866.3471990399999;1345.87;520314.9499581907;3793189.294903181;3659855.2149031814;3432263.8572089905
694.44;857.87;132639.6399999996;214.5;94.57206331999971;1861.3820633199996;1345.87;521406.1490397717;3798521.5589679014;3665881.9189679017;3437970.6254298277
694.44;853.4;131945.1999999996;214.5;94.07692759999972;1856.4169275999998;1345.87;522650.37874097435;3803861.318846262;3671916.1188462623;3443684.4397154865
694.44;848.93;131250.7599999996;214.5;93.58179187999971;1851.4517918799995;1345.87;523891.38539876917;3809208.5850754795;3677957.8250754797;3449405.3099709507
694.44;844.47;130556.3199999996;214.5;93.0866561599997;1846.4966561599997;1345.87;525129.1744964303;3814563.3682075827;3684007.048207583;3455133.246115128
694.44;840.0;129861.8799999996;214.5;92.59152043999971;1841.5315204399997;1345.87;526363.7314968252;3819925.678809435;3690063.7988094357;3460868.2580808694
694.44;835.53;129167.4399999996;214.5;92.0963847199997;1836.5663847199996;1345.87;527595.0518564433;3825295.527462754;3696128.0874627545;3466610.355814989
694.44;831.06;128472.99999999959;214.5;91.60124899999971;1831.6012489999998;1345.87;528823.1310253865;3830672.924764131;3702199.9247641317;3472359.549278284
694.44;826.59;127778.55999999959;214.5;91.1061132799997;1826.6361132799998;1345.87;530047.9644473614;3836057.881325056;3708279.3213250563;3478115.848445553
694.44;822.13;127084.11999999959;214.5;90.61097755999971;1821.68097756;1345.87;531269.5575737267;3841450.4077719334;3714366.2877719337;3483879.2633056175
694.44;817.66;126389.67999999959;214.5;90.1158418399997;1816.7158418399997;1372.79;532460.9379926831;3846850.514746107;3720460.8347461075;3489649.803861341
694.44;813.19;125695.23999999958;214.5;89.6207061199997;1811.75070612;1372.79;533649.0210755174;3852258.21290388;3726562.9729038803;3495427.4801296475
694.44;808.72;125000.79999999958;214.5;89.1255703999997;1806.7855703999999;1372.79;534833.8021870095;3857673.512916535;3732672.7129165353;3501212.302141543
694.44;804.25;124306.35999999958;214.5;174.65043579999943;1887.8404357999996;1372.79;535940.58718361;3863096.425470356;3738790.0654703565;3507004.2799421353
694.44;799.79;123611.91999999958;214.5;173.67474759999942;1882.4047475999994;1372.79;537204.3151356613;3868526.9612666485;3744915.041266649;3512803.4235906503
694.44;795.32;122917.47999999957;214.5;172.69905939999944;1876.9590593999997;1372.79;538464.3662258951;3873965.1310217623;3751047.6510217628;3518609.743160457
694.44;790.85;122223.03999999957;214.5;171.72337119999943;1871.5133711999995;1372.79;539720.7352855745;3879410.945467111;3757187.9054671116;3524423.248739085
694.44;786.38;121528.59999999957;214.5;170.74768299999943;1866.0676829999995;1372.79;540973.4171386962;3884864.4153491952;3763335.8153491956;3530243.9504282437
694.44;781.91;120834.15999999957;214.5;169.77199479999942;1860.6219947999994;1372.79;542222.4066019813;3890325.5514296205;3769491.391429621;3536071.8583438434
694.44;777.45;120139.71999999956;214.5;168.7963065999994;1855.1863065999996;1372.79;543467.7084989215;3895794.3644851213;3775654.6444851216;3541906.9826160143
694.44;772.98;119445.27999999956;214.5;167.8206183999994;1849.7406183999994;1372.79;544709.3076316746;3901270.8653075816;3781825.5853075823;3547749.3333891276
694.44;768.51;118750.83999999956;214.5;166.8449301999994;1844.2949301999995;1400.24;545919.710207339;3906755.064704056;3788004.2247040565;3553598.920821813
694.44;764.04;118056.39999999956;214.5;165.86924199999942;1838.8492419999993;1400.24;547126.3609592039;3912246.9734967905;3794190.573496791;3559455.7550869836
694.44;759.57;117361.95999999956;214.5;164.8935537999994;1833.4035537999996;1400.24;548329.2546131545;3917746.6025232454;3800384.642523246;3565319.846371851
694.44;755.1;116667.51999999955;214.5;163.9178655999994;1827.9578655999994;1400.24;549528.3858876621;3923253.9626361155;3806586.442636116;3571191.204877949
694.44;750.64;115973.07999999955;214.5;162.9421773999994;1822.5221773999992;1400.24;550558.5423799786;3928769.0647033514;3812795.9847033517;3577069.8408211507
694.44;746.17;115278.63999999955;214.5;161.9664891999994;1817.0764891999995;1400.24;551749.9107959763;3934291.919608181;3819013.279608181;3582955.7644316903
694.44;741.7;114584.19999999955;214.5;160.99080099999938;1811.6308009999996;1400.24;552937.5006309636;3939822.5382491318;3825238.338249132;3588848.985954184
694.44;737.23;113889.75999999954;214.5;160.01511279999937;1806.1851127999994;1400.24;554121.3065732119;3945360.931540052;3831471.1715400526;3594749.5156476498
694.44;732.76;113195.31999999954;214.5;159.0394245999994;1800.7394245999994;1400.24;555301.3233035259;3950907.110410131;3837711.7904101317;3600657.363785524
694.44;728.3;112500.87999999954;214.5;158.06373639999939;1795.3037363999995;1400.24;556477.5555092901;3956461.085803923;3843960.205803924;3606572.5406556884
694.44;723.83;111806.43999999954;214.5;157.08804819999938;1789.8580481999993;1400.24;557649.9878563633;3962022.8686813675;3850216.428681368;3612495.056560486
694.44;719.36;111111.99999999953;214.5;156.11235999999937;1784.4123599999996;1428.25;558790.5656281356;3967592.4700178094;3856480.47001781;3618424.921816741
694.44;714.89;110417.55999999953;214.5;155.13667179999936;1778.9666717999994;1428.25;559927.2934201071;3973169.9008040237;3862752.340804024;3624362.146755783
694.44;710.42;109723.11999999953;214.5;154.16098359999935;1773.5209835999995;1428.25;561060.1658201809;3978755.172046235;3869032.052046235;3630306.741723461
694.44;705.96;109028.67999999953;214.5;153.18529539999935;1768.0852953999995;1428.25;562189.1874227091;3984348.2947661397;3875319.61476614;3636258.7170801717
694.44;701.49;108334.23999999953;214.5;152.20960719999937;1762.6396071999993;1428.25;563314.3428003875;3989949.2800009283;3881615.0400009286;3642218.083200873
694.44;697.02;107639.79999999952;214.5;151.23391899999936;1757.1939189999994;1428.25;564266.2958303271;3995558.138803307;3887918.3388033076;3648184.850475109
694.44;692.55;106945.35999999952;214.5;150.25823079999935;1751.7482307999994;1428.25;565383.4644097768;4001174.8822415187;3894229.5222415193;3654159.0293070283
694.44;688.08;106250.91999999952;214.5;149.28254259999935;1746.3025425999992;1428.25;566496.7501020264;4006799.5213993657;3900548.6013993663;3660140.6301154043
694.44;683.62;105556.47999999952;214.5;148.30685439999934;1740.8668543999993;1428.25;567606.1574627768;4012432.0673762313;3906875.587376232;3666129.663333658
694.44;679.15;104862.03999999951;214.5;147.33116619999933;1735.4211661999996;1428.25;568711.671026018;4018072.531287102;3913210.4912871025;3672126.1394098764
694.44;674.68;104167.59999999951;214.5;146.35547799999932;1729.9754779999992;1428.25;569813.2853180564;4023720.924262589;3919553.324262589;3678130.068806834
694.44;670.21;103473.15999999951;214.5;145.37978979999934;1724.5297897999994;1456.81;570882.3947093721;4029377.2574489494;3925904.0974489497;3684141.462002013
694.44;665.74;102778.7199999995;214.5;144.40410159999934;1719.0841015999995;1456.81;571947.5536544335;4035041.542008111;3932262.8220081115;3690160.329487625
694.44;661.28;102084.2799999995;214.5;143.42841339999933;1713.6484133999993;1456.81;573008.7666139702;4040713.7891176906;3938629.5091176913;3696186.6817706297
694.44;656.81;101389.8399999995;214.5;142.45272519999932;1708.2027251999993;1456.81;574066.018026868;4046394.0099710193;3945004.16997102;3702220.5293727587
694.44;652.34;100695.3999999995;214.5;141.4770369999993;1702.7570369999994;1456.81;575119.302324195;4052082.2157771625;3951386.815777163;3708261.882830533
694.44;647.87;100000.9599999995;214.5;140.5013487999993;1697.3113487999992;1456.81;576168.6139291909;4057778.4177609426;3957777.457760943;3714310.7526952866
694.44;643.4;99306.5199999995;214.5;139.5256605999993;1691.8656605999995;1456.81;577040.7830730786;4063482.6271629618;3964176.107162962;3720367.1495331847
694.44;638.93;98612.07999999949;214.5;138.54997239999932;1686.419972399999;1456.81;578081.889106748;4069194.855239623;3970582.7752396236;3726431.0839252463
694.44;634.47;97917.63999999949;214.5;137.5742841999993;1680.9842841999994;1456.81;579119.0153425875;4074915.1132631535;3976997.473263154;3732502.566467365
694.44;630.0;97223.19999999949;214.5;136.5985959999993;1675.5385959999994;1456.81;580152.1461719511;4080643.412521626;3983420.2125216266;3738581.607770329
694.44;625.53;96528.75999999949;214.5;135.6229077999993;1670.0929077999992;1456.81;581181.2759783085;4086379.764318981;3989851.004318982;3744668.218459843
694.44;621.06;95834.31999999948;214.5;134.6472195999993;1664.6472195999993;1485.95;582177.2181737697;4092124.1799750514;3996289.859975052;3750762.409176549
694.44;616.59;95139.87999999948;214.5;133.67153139999928;1659.2015313999996;1485.95;583169.1070684182;4097876.67082558;4002736.7908255807;3756864.190576046
694.44;612.13;94445.43999999948;214.5;132.69584319999927;1653.7658431999994;1485.95;584156.9469783964;4103637.248222247;4009191.8082222478;3762973.5733289127
694.44;607.66;93750.99999999948;214.5;131.7201549999993;1648.3201549999992;1485.95;585140.7221977994;4109405.92353269;4015654.9235326904;3769090.568120729
694.44;603.19;93056.55999999947;214.5;130.7444667999993;1642.8744667999995;1485.95;586120.4270127007;4115182.7081405255;4022126.148140526;3775215.1856520944
694.44;598.72;92362.11999999947;214.5;129.76877859999928;1637.4287785999993;1485.95;587096.0557011422;4120967.6134453733;4028605.4934453736;3781347.4366386514
694.44;594.25;91667.67999999947;214.5;128.79309039999927;1631.9830903999994;1485.95;588067.6025331216;4126760.6508628777;4035092.9708628785;3787487.331811106
694.44;589.79;90973.23999999947;214.5;127.81740219999926;1626.5474021999994;1485.95;588858.3612631039;4132561.831824731;4041588.591824732;3793634.881915248
694.44;585.32;90278.79999999946;214.5;126.84171399999926;1621.1017139999994;1485.95;589821.48877779;4138371.1677786955;4048092.367778696;3799790.0977119743
694.44;580.85;89584.35999999946;214.5;125.86602579999926;1615.6560257999993;1485.95;590780.5168625278;4144188.670188626;4054604.3101886264;3805952.989977309
694.44;576.38;88889.91999999946;214.5;124.89033759999926;1610.2103375999993;1485.95;591735.4397545565;4150014.350534492;4061124.4305344927;3812123.569502423
694.44;571.91;88195.47999999946;214.5;123.91464939999926;1604.7646493999991;1515.67;592656.4899042165;4155848.2203124026;4067652.740312403;3818301.847093659
694.44;567.45;87501.03999999946;214.5;122.93896119999926;1599.3289611999994;1515.67;593573.3914878607;4161690.291034626;4074189.2510346263;3824487.833572549
694.44;562.98;86806.59999999945;214.5;121.96327299999925;1593.8832729999992;1515.67;594486.1286595976;4167540.574229614;4080733.9742296143;3830681.539775837
694.44;558.51;86112.15999999945;214.5;120.98758479999924;1588.4375847999993;1515.67;595394.6955653183;4173399.0814420246;4087286.9214420253;3836882.976555504
694.44;554.04;85417.71999999945;214.5;120.01189659999923;1582.9918965999993;1515.67;596299.0863426842;4179265.824232745;4093848.1042327457;3843092.154778781
694.44;549.57;84723.27999999945;214.5;119.03620839999924;1577.5462083999994;1515.67;597199.295121116;4185140.8141789134;4100417.534178914;3849309.0853281794
694.44;545.11;84028.83999999944;214.5;118.06052019999923;1572.1105201999994;1515.67;598095.3260358389;4191024.0628739432;4106995.222873944;3855533.7791015073
694.44;540.64;83334.39999999944;214.5;117.08483199999924;1566.6648319999993;1515.67;598987.1631997768;4196915.581927545;4113581.181927546;3861766.2470118934
694.44;536.17;82639.95999999944;214.5;183.79127103999875;1628.9012710399988;1515.67;599762.5952153609;4202815.38296575;4120175.4229657506;3868006.4999878057
694.44;531.7;81945.51999999944;214.5;182.24683647999873;1622.886836479999;1515.67;600713.0771761553;4208723.477630932;4126777.9576309323;3874254.5489730765
694.44;527.23;81251.07999999943;214.5;180.70240191999872;1616.8724019199988;1515.67;601658.87238468;4214639.877581831;4133388.7975818315;3880510.4049269217
694.44;522.76;80556.63999999943;214.5;179.15796735999874;1610.8579673599988;1545.98;602569.6216443591;4220564.594493577;4140007.9544935776;3886774.078823963
694.44;518.3;79862.19999999943;214.5;177.61353279999872;1604.8535327999987;1545.98;603475.6383117049;4226497.640057712;4146635.4400577126;3893045.5816542497
694.44;513.83;79167.75999999943;214.5;176.0690982399987;1598.8390982399987;1545.98;604376.9057198329;4232439.025982213;4153271.265982214;3899324.924423281
694.44;509.36;78473.31999999942;214.5;174.5246636799987;1592.8246636799988;1545.98;605273.4171924865;4238388.763991516;4159915.4439915167;3905612.1181520256
694.44;504.89;77778.87999999942;214.5;172.9802291199987;1586.8102291199987;1545.98;606165.1660440244;4244346.865826538;4166567.9858265384;3911907.1738769463
694.44;500.42;77084.43999999942;214.5;171.4357945599987;1580.7957945599987;1545.98;607052.1455794068;4250313.343244701;4173228.903244701;3918210.1026500193
694.44;495.96;76389.99999999942;214.5;169.89135999999868;1574.7913599999988;1545.98;607934.3591082398;4256288.208019954;4179898.2080199546;3924520.9155387576
694.44;491.49;75695.55999999942;214.5;168.3469254399987;1568.7769254399986;1545.98;608811.7899166668;4262271.4719428;4186575.9119428005;3930839.6236262326
694.44;487.02;75001.11999999941;214.5;166.8024908799987;1562.7624908799987;1545.98;609684.4312813936;4268263.146820313;4193262.026820314;3937166.238011095
694.44;482.55;74306.67999999941;214.5;165.25805631999867;1556.7480563199988;1545.98;610369.1107867338;4274263.2444761675;4199956.564476168;3943500.7698075976
694.44;478.08;73612.23999999941;214.5;163.71362175999866;1550.7336217599986;1545.98;611231.8955717692;4280271.776750658;4206659.536750658;3949843.230145619
694.44;473.62;72917.7999999994;214.5;162.16918719999867;1544.7291871999987;1576.9;612058.9168728662;4286288.755500723;4213370.955500723;3956193.6301706797
694.44;469.15;72223.3599999994;214.5;160.62475263999866;1538.7147526399988;1576.9;612881.0778672547;4292314.192599969;4220090.83259997;3962551.9810439716
694.44;464.68;71528.9199999994;214.5;159.08031807999865;1532.7003180799989;1576.9;613698.3717225736;4298348.099938694;4226819.179938695;3968918.2939423737
694.44;460.21;70834.4799999994;214.5;157.53588351999866;1526.6858835199987;1576.9;614510.7915968575;4304390.489423912;4233556.0094239125;3975292.580058478
694.44;455.74;70140.0399999994;214.5;155.99144895999865;1520.6714489599988;1576.9;615318.3306385224;4310441.372979373;4240301.332979374;3981674.8506006114
694.44;451.28;69445.5999999994;214.5;154.44701439999864;1514.6670143999986;1576.9;616120.9920004107;4316500.762545589;4247055.16254559;3988065.1167928544
694.44;446.81;68751.15999999939;214.5;152.90257983999865;1508.6525798399987;1576.9;616918.7588116816;4322568.670079861;4253817.510079862;3994463.38987507
694.44;442.34;68056.71999999939;214.5;151.35814527999864;1502.6381452799985;1576.9;617711.624191836;4328645.107556294;4260588.387556294;4000869.6811029166
694.44;437.87;67362.27999999939;214.5;149.81371071999862;1496.6237107199986;1576.9;618499.581250702;4334730.086965827;4267367.806965828;4007284.0017478783
694.44;433.4;66667.83999999939;214.5;148.2692761599986;1490.6092761599987;1576.9;619282.6230884225;4340823.620316259;4274155.78031626;4013706.363097284
694.44;428.94;65973.39999999938;214.5;146.72484159999863;1484.6048415999987;1576.9;619874.7345836551;4346925.719632262;4280952.319632263;4020136.776454327
694.44;424.47;65278.95999999938;214.5;145.1804070399986;1478.5904070399988;1608.44;620616.0894370355;4353036.396955418;4287757.436955419;4026575.253138094
694.44;420.0;64584.51999999938;214.5;143.6359724799986;1472.5759724799987;1608.44;621352.4635583645;4359155.664344234;4294571.144344235;4033021.804483581
694.44;415.53;63890.079999999376;214.5;142.09153791999861;1466.5615379199987;1608.44;622083.8499459939;4365283.533874167;4301393.453874168;4039476.441841718
694.44;411.06;63195.639999999374;214.5;140.5471033599986;1460.5471033599986;1608.44;622810.2415884323;4371420.0176376505;4308224.377637651;4045939.1765793916
694.44;406.59;62501.19999999937;214.5;139.0026687999986;1454.5326687999986;1608.44;623531.6314643323;4377565.127744117;4315063.927744118;4052410.0200794707
694.44;402.13;61806.75999999937;214.5;137.45823423999857;1448.5282342399987;1608.44;624248.0225565336;4383718.87632002;4321912.1163200205;4058888.983740819
694.44;397.66;61112.31999999937;214.5;135.9137996799986;1442.5137996799988;1608.44;624959.3978239539;4389881.275508863;4328768.955508864;4065376.0789783318
694.44;393.19;60417.879999999364;214.5;134.36936511999858;1436.4993651199986;1608.44;625665.7502156133;4396052.337471217;4335634.457471218;4071871.317222945
694.44;388.72;59723.43999999936;214.5;132.82493055999856;1430.4849305599987;1608.44;626367.0726706198;4402232.074384749;4342508.634384749;4078374.7099216646
694.44;384.25;59028.99999999936;214.5;131.28049599999858;1424.4704959999985;1608.44;627063.3581181554;4408420.498444245;4349391.498444246;4084886.268537591
694.44;379.79;58334.55999999936;214.5;129.73606143999856;1418.4660614399986;1608.44;627754.6094915201;4414617.621861634;4356283.061861634;4091406.0045499364
694.44;375.32;57640.119999999355;214.5;128.19162687999855;1412.4516268799985;1640.61;628220.0718988016;4420823.45686601;4363183.336866011;4097933.9294540505
694.44;370.85;56945.67999999935;214.5;126.64719231999854;1406.4371923199985;1640.61;628868.6883174262;4427038.01570366;4370092.335703661;4104470.054761441
694.44;366.38;56251.23999999935;214.5;125.10275775999855;1400.4227577599986;1640.61;629512.1936372333;4433261.310638086;4377010.070638087;4111014.3919998016
694.44;361.91;55556.79999999935;214.5;123.55832319999854;1394.4083231999987;1640.61;630150.5806733114;4439493.353950027;4383936.5539500285;4117566.9527130267
694.44;357.45;54862.359999999346;214.5;122.01388863999853;1388.4038886399985;1640.61;630783.8522447065;4445734.15793749;4390871.797937491;4124127.7484612414
694.44;352.98;54167.91999999934;214.5;120.46945407999853;1382.3894540799986;1640.61;631411.9911463127;4451983.734915767;4397815.814915768;4130696.790820822
694.44;348.51;53473.47999999934;214.5;118.92501951999853;1376.3750195199987;1640.61;632034.9901628952;4458242.097217461;4404768.617217462;4137274.091384414
694.44;344.04;52779.03999999934;214.5;117.38058495999852;1370.3605849599985;1640.61;632652.8420690768;4464509.257192514;4411730.217192515;4143859.661760964
694.44;339.57;52084.59999999934;214.5;115.83615039999852;1364.3461503999986;1640.61;633265.5396293231;4470785.227208228;4418700.627208228;4150453.5135757346
694.44;335.11;51390.159999999334;214.5;114.29171583999852;1358.3417158399986;1640.61;633873.0856119855;4477070.0196492905;4425679.859649291;4157055.658470334
694.44;330.64;50695.71999999933;214.5;112.7472812799985;1352.3272812799985;1640.61;634475.4627611926;4483363.646917798;4432667.926917798;4163666.10810273
694.44;326.17;50001.27999999933;214.5;111.2028467199985;1346.3128467199986;1673.42;635039.807688317;4489666.121433281;4439664.841433282;4170284.8741472852
694.44;321.7;49306.83999999933;214.5;109.6584121599985;1340.2984121599986;1673.42;635408.2433753209;4495977.455632731;4446670.615632732;4176911.9682947686
694.44;317.23;48612.399999999325;214.5;108.11397759999849;1334.2839775999985;1673.42;635961.8537772299;4502297.661970621;4453685.2619706215;4183547.4022523845
694.44;312.77;47917.95999999932;214.5;106.56954303999849;1328.2795430399985;1673.42;636510.229539966;4508626.752918932;4460708.792918933;4190191.187743797
694.44;308.3;47223.51999999932;214.5;105.02510847999848;1322.2651084799984;1673.42;637053.3532908938;4514964.740967177;4467741.220967177;4196843.336509147
694.44;303.83;46529.07999999932;214.5;103.48067391999848;1316.2506739199985;1673.42;637591.2176470142;4521311.638622426;4474782.558622427;4203503.860305082
694.44;299.36;45834.639999999315;214.5;101.93623935999847;1310.2362393599988;1673.42;638123.8152149492;4527667.458409334;4481832.818409334;4210172.770904774
694.44;294.89;45140.19999999931;214.5;100.39180479999847;1304.2218047999984;1673.42;638651.1385909277;4534032.212870156;4488892.012870157;4216850.080097947
694.44;290.42;44445.75999999931;214.5;98.84737023999845;1298.2073702399987;1673.42;639173.1803607707;4540405.914564786;4495960.154564787;4223535.799690899
694.44;285.96;43751.31999999931;214.5;97.30293567999846;1292.2029356799985;1673.42;639689.9431139342;4546788.576070767;4503037.2560707675;4230229.941506522
694.44;281.49;43056.879999999306;214.5;95.75850111999846;1286.1885011199986;1673.42;640201.4094153997;4553180.209983327;4510123.3299833285;4236932.517384329
694.44;277.02;42362.439999999304;214.5;94.21406655999844;1280.1740665599984;1706.89;640674.0547693479;4559580.8289153995;4517218.3889154;4243643.539180476
694.44;272.55;41667.9999999993;214.5;92.66963199999844;1274.1596319999985;1706.89;641141.3416537012;4565990.445497647;4524322.445497648;4250363.018767789
694.44;268.08;40973.5599999993;214.5;109.07161671999813;1286.091616719998;1706.89;641428.7478129555;4572409.072378488;4531435.512378489;4257090.968035779
694.44;263.62;40279.1199999993;214.5;107.22301743999813;1279.783017439998;1706.89;641902.7268952063;4578836.722224123;4538557.602224124;4263827.398890676
694.44;259.15;39584.679999999295;214.5;105.37441815999811;1273.4644181599983;1706.89;642371.0447904478;4585273.407718555;4545688.727718555;4270572.323255442
694.44;254.68;38890.23999999929;214.5;103.52581887999811;1267.1458188799982;1706.89;642833.6935404842;4591719.14156362;4552828.901563621;4277325.753069804
694.44;250.21;38195.79999999929;214.5;101.67721959999811;1260.8272195999982;1706.89;643290.6651759319;4598173.93647901;4559978.136479011;4284087.70029027
694.44;245.74;37501.35999999929;214.5;99.8286203199981;1254.508620319998;1706.89;643741.9517162049;4604637.805202294;4567136.445202295;4290858.176890157
694.44;241.28;36806.919999999285;214.5;97.98002103999809;1248.200021039998;1706.89;644187.5551835558;4611110.760488951;4574303.840488952;4297637.194859615
694.44;236.81;36112.47999999928;214.5;96.13142175999809;1241.8814217599981;1706.89;644627.457574965;4617592.815112388;4581480.335112388;4304424.766205645
694.44;232.34;35418.03999999928;214.5;94.28282247999807;1235.5628224799982;1706.89;645061.6508761627;4624083.981863971;4588665.941863972;4311220.902952134
694.44;227.87;34723.59999999928;214.5;92.43422319999807;1229.244223199998;1741.02;645455.9490834717;4630584.273553045;4595860.673553045;4318025.617139862
694.44;223.4;34029.159999999276;214.5;90.58562391999807;1222.9256239199983;1741.02;645844.474092629;4637093.703006961;4603064.543006962;4324838.920826545
694.44;218.94;33334.71999999927;214.5;88.73702463999807;1216.6170246399981;1741.02;646227.2278020369;4643612.283071106;4610277.5630711075;4331660.8260868415
694.44;214.47;32640.279999999275;214.5;86.88842535999807;1210.2984253599982;1741.02;646410.2108270257;4650140.026608922;4617499.746608922;4338491.345012387
694.44;210.0;31945.839999999276;214.5;85.03982607999806;1203.979826079998;1741.02;646781.1048558275;4656676.946501931;4624731.106501932;4345330.489711816
694.44;205.53;31251.399999999277;214.5;83.19122679999808;1197.661226799998;1741.02;647146.1927861265;4663223.055649769;4631971.655649769;4352178.272310783
694.44;201.06;30556.95999999928;214.5;81.34262751999808;1191.3426275199981;1741.02;647505.4664560177;4669778.3669702;4639221.406970201;4359034.704951989
694.44;196.6;29862.51999999928;214.5;79.49402823999807;1185.034028239998;1741.02;647858.9277061801;4676342.893399151;4646480.3733991515;4365899.799795203
694.44;192.13;29168.07999999928;214.5;77.64542895999809;1178.7154289599982;1741.02;648206.5583517654;4682916.647890731;4653748.567890732;4372773.569017287
694.44;187.66;28473.639999999283;214.5;75.79682967999808;1172.396829679998;1741.02;648548.3501964193;4689499.643417261;4661026.003417261;4379656.024812225
694.44;183.19;27779.199999999284;214.5;73.9482303999981;1166.0782303999981;1741.02;648884.2950322654;4696091.892969296;4668312.692969297;4386547.179391139
694.44;178.72;27084.759999999285;214.5;72.0996311199981;1159.7596311199982;1775.84;649179.5156917825;4702693.409555656;4675608.649555657;4393447.044982318
694.44;174.25;26390.319999999287;214.5;70.25103183999809;1153.4410318399982;1775.84;649468.823875193;4709304.206203444;4682913.886203445;4400355.633831238
694.44;169.79;25695.879999999288;214.5;68.4024325599981;1147.132432559998;1775.84;649752.2212851096;4715924.295958078;4690228.415958079;4407272.958200594
694.44;165.32;25001.43999999929;214.5;66.5538332799981;1140.813833279998;1775.84;650029.6895984233;4722553.6918833135;4697552.251883314;4414199.030370316
694.44;160.85;24306.99999999929;214.5;64.70523399999811;1134.4952339999982;1775.84;650106.1301141809;4729192.407061271;4704885.407061272;4421133.862637596
694.44;156.38;23612.559999999292;214.5;62.85663471999811;1128.1766347199982;1775.84;650371.4409704687;4735840.454592463;4712227.894592463;4428077.467316915
694.44;151.91;22918.119999999293;214.5;61.008035439998125;1121.858035439998;1775.84;650630.797305037;4742497.847595813;4719579.727595814;4435029.856740065
694.44;147.45;22223.679999999295;214.5;59.15943615999812;1115.5494361599983;1775.84;650884.2007613931;4749164.599208691;4726940.919208691;4441991.04325617
694.44;142.98;21529.239999999296;214.5;57.31083687999812;1109.2308368799982;1775.84;651131.632957239;4755840.7225869335;4734311.482586934;4448961.0392317185
694.44;138.51;20834.799999999297;214.5;55.46223759999812;1102.9122375999982;1775.84;651373.0854984942;4762526.230904871;4741691.430904872;4455939.85705058
694.44;134.04;20140.3599999993;214.5;53.61363831999813;1096.5936383199983;1775.84;651608.5499792777;4769221.137355352;4749080.777355352;4462927.509114032
694.44;129.57;19445.9199999993;214.5;51.765039039998136;1090.275039039998;1811.36;651802.4480497624;4775925.455149773;4756479.535149774;4469924.007840787
694.44;125.11;18751.4799999993;214.5;49.916439759998134;1083.9664397599984;1811.36;651990.3012242833;4782639.1975181;4763887.7175181005;4476929.365667014
694.44;120.64;18057.039999999302;214.5;48.06784047999814;1077.647840479998;1811.36;652172.0909911894;4789362.377708901;4771305.337708902;4483943.5950463675
694.44;116.17;17362.599999999304;214.5;46.219241199998145;1071.3292411999983;1811.36;652347.808826864;4796095.008989363;4778732.408989363;4490966.708450002
694.44;111.7;16668.159999999305;214.5;44.37064191999815;1065.0106419199983;1811.36;652517.4461957089;4802837.104645328;4786168.944645328;4497998.718366609
694.44;107.23;15973.719999999304;214.5;42.52204263999815;1058.6920426399981;1811.36;652485.1902517616;4809588.677981311;4793614.957981312;4505039.637302433
694.44;102.77;15279.279999999304;214.5;40.673443359998146;1052.3834433599982;1811.36;652642.3757949125;4816349.742320533;4801070.462320534;4512089.477781301
694.44;98.3;14584.839999999303;214.5;38.824844079998144;1046.0648440799982;1811.36;652793.4548195209;4823120.31100494;4808535.4710049415;4519148.252344646
694.44;93.83;13890.399999999303;214.5;36.97624479999814;1039.7462447999983;1811.36;652938.4187413674;4829900.397395238;4816009.997395239;4526215.973551525
694.44;89.36;13195.959999999302;214.5;35.12764551999814;1033.4276455199981;1811.36;653077.2589641653;4836690.014870911;4823494.054870912;4533292.653978657
694.44;84.89;12501.519999999302;214.5;33.27904623999814;1027.1090462399982;1811.36;653209.9668795437;4843489.176830253;4830987.656830253;4540378.306220438
694.44;80.43;11807.079999999301;214.5;31.43044695999814;1020.8004469599982;1847.59;653300.262950878;4850297.896690392;4838490.816690393;4547472.94288897
694.44;75.96;11112.639999999301;214.5;29.581847679998138;1014.4818476799983;1847.59;653384.3584740027;4857116.1878873175;4846003.547887318;4554576.576614079
694.44;71.49;10418.1999999993;214.5;27.73324839999814;1008.1632483999982;1847.59;653462.2447325165;4863944.063875907;4853525.863875908;4561689.220043354
694.44;67.02;9723.7599999993;214.5;25.884649119998134;1001.8446491199982;1847.59;653533.9129977648;4870781.538129951;4861057.778129952;4568810.885842155
694.44;62.55;9029.3199999993;214.5;24.036049839998135;995.5260498399981;1847.59;653599.3545288229;4877628.624142181;4868599.304142182;4575941.586693651
694.44;58.08;8334.879999999299;214.5;22.187450559998133;989.2074505599983;1847.59;653658.5605724787;4884485.3354242975;4876150.4554242985;4583081.335298841
694.44;53.62;7640.439999999298;214.5;20.33885127999813;982.8988512799982;1847.59;653515.4189175594;4891351.685506993;4883711.2455069935;4590230.144376574
694.44;49.15;6945.999999999298;214.5;18.49025199999813;976.5802519999982;1847.59;653561.8620197854;4898227.687939981;4891281.687939982;4597388.026663583
694.44;44.68;6251.559999999297;214.5;16.641652719998127;970.2616527199981;1847.59;653602.0429276268;4905113.356292023;4898861.796292024;4604554.994914502
694.44;40.21;5557.119999999297;214.5;14.793053439998127;963.9430534399983;1847.59;653635.9528380231;4912008.704150956;4906451.584150957;4611731.0619019
694.44;35.74;4862.679999999296;214.5;12.944454159998127;957.6244541599982;1847.59;653663.5829355393;4918913.745123715;4914051.065123715;4618916.240416292
694.44;31.28;4168.239999999296;214.5;11.095854879998125;951.3158548799981;1884.54;653647.9324640577;4925828.4928363655;4921660.252836366;4626110.543266185
694.44;26.81;3473.799999999296;214.5;9.247255599998125;944.9972555999981;1884.54;653625.9325103431;4932752.960934127;4929279.160934128;4633313.98327808
694.44;22.34;2779.3599999992957;214.5;7.398656319998125;938.6786563199983;1884.54;653597.5741486308;4939687.1630814;4936907.803081401;4640526.573296517
694.44;17.87;2084.9199999992957;214.5;5.550057039998125;932.3600570399982;1884.54;653562.8484406082;4946631.112961795;4944546.192961796;4647748.326184088
694.44;13.4;1390.4799999992956;214.5;3.7014577599981253;926.0414577599981;1884.54;653521.7464353982;4953584.824278158;4952194.344278159;4654979.254821469
694.44;8.94;696.0399999992956;214.5;1.8528584799981247;919.7328584799982;1884.54;653474.2691835983;4960548.310752597;4959852.270752598;4662219.372107442
694.44;4.47;1.5999999992955054;214.5;0.004259199998124635;913.4142591999982;1884.54;653420.3977091678;4967521.586126509;4967519.9861265095;4669468.690958919
694.44;0.0;-692.8400000007045;214.5;-2.2829078000023215;906.6570921999977;;;;;
